aah	_EXCL
aamiin	amin
aamiinn	amin
aamin	amin
aammiin	amin
aatau	atau
aatauhari	atau hari
ab	_UNDF
ababil	ababil
abaikanbigot	abaikan bigot
abaikantangisannya	abaikan tangis
abd	_UNDF
abg	_UNDF
abil	ambil
abis	habis
abisin	habis
abiz	habis
acau	kacau
achok	ahok
adadenganindonesia	ada dengan indonesia
adain	adakan
adalahkami	adalah kami
adalh	adalah
adax	adanya
aday	ada
adaya	ada ya
adek	adik
adh	adalah
adhan	azan
adiliahok	adil ahok
adilin	adili
adilipenistaagama	adili penista agama
adis	_UNDF
adkah	adakah
adl	adalah
adlah	adalah
adlh	adalah
ado	ada
adoy	_UNDF
aduhh	_EXCL
advantages	advantage
adzan	azan
adzan	azan
adzandnya	azan nya
adzannya	azan nya
adzanx	azan nya
adzanya	azan nya
aer	air
afkan	_UNDF
afu	_UNDF
agamaataualqur	agama atau alquran
agana	agama
agap	_UNDF
agendain	agendakan
agm	agama
agma	agama
agogtamat	ahok tamat
agr	agar
agungnyaichi	_UNDF
agusabar	agus sabar
ahaha	_LOL
ahahaha	_LOL
ahai	_EXCL
ahehehehe	_LOL
ahh	_EXCL
ahhh	_EXCL
ahhok	ahok 
ahik	ahok
ahir	akhir
ahiran	akhiran
ahirnya	akhirnya
ahk	ahok
ahkirnya	akhirnya
ahklaknya	akhlaknya
ahlamdulillah	alhamdulillah
ahlulsunnah	ahlul sunnah
ahlusunnah	ahlul sunnah
aho	ahok
ahoax	ahoak
ahoaxx	ahoak
ahog	ahoak
ahokers	ahoker
ahokk	ahok
aihihihihi	_LOL
ail	_UNDF
ailopyu	I love you
airmat	air mata
airmata	air mata
airmatamu	air matamu
airmatanya	air matanya
airmatatipu	air mata tipu
aiskrim	es krim
aj	saja
aja	saja
ajaa	saja
ajah	saja
ajalah	sajalah
ajan	azan
ajarin	ajarkan
ajateh	saja teh
aje	saja
ajengkertini	ajeng kartini
ajh	saja
aji	haji
ajib	ajib
ajibbb	ajib
ajil	_UNDF
ajk	ajak
ak	aku
ak	aku
aka	_UNDF
akalakalan	akal akalan
akalakaln	akal akalan
akaln	akal
akankena	akan kena
akherat	akhirat
akhierat	akhirat
akhirny	akhirnya
akhirnyamush	akhirnya musuh
akhirzaman	akhir zaman
akhlakul	akhlak
akhrny	akhir
akirnya	akhir
akok	ahoak
aktifin	aktifkan
aktifkan	aktifkan
akuu	aku
akuwa	aqua
akyat	rakyat
alahuakbar	allah akbar
alakadarnya	ala kadar
alallohu	allah
alesan	alasan
alhamdulilah	alhamdulillah
alhamdulillaah	alhamdulillah
alhamdulillahongkos	alhamdulillah ongkos
alhamdulillh	alhamdulillah
alhamdullilah	alhamdulillah
alhamdullilah	alhamdulillah
alhmdllah	alhamdulillah
alhmdllh	alhamdulillah
alhmdulillah	alhamdulillah
alhmdullh	alhamdulillah
alimulama	alim ulama
alkuran	alquran
allaah	allah
allaahu	allah
allahpower	allah power
allahu	allah
allahuakbar	allah akbar
allahughayatuna	allah
allahumaamiin	allahumma amin
allahummaa	allah
allahummansur	allah
allhamadulillah	alhamdulillah
alloh	allah
allohhh	allah
allohu	allah
allohu	allah
allohumma	allah
allow	hallo
almaida	almaidah
alqur	alquran
alquraan	alquran
alrm	alarm
amajing	amazing
ambi_LOLeh	ambil oleh
amcaman	ancaman
america	amerika
amiin	amin
aminn	amin
amplikasi	aplikasi
ampunnnn	ampun
amrik	amerika
amriki	amerika
an	_UNDF
anaknnya	anaknya
anarchy	anarki
anbiarkekinian	biar kekinian
ancur	hancur
ancuur	hancur
ane	ana
anget	hangat
angktpn	angkat pun
anjeun	_UNDF
anjingin	anjing
anjrott	anjrot
anjuer	anjrot
ank	anak
antasarikan	antasari kan
antiahok	anti ahok
antibhineka	anti bhineka
antidajjal	anti dajjal
antikorupsi	anti korupsi
antiliberal	anti liberal
antiorientalist	anti orientalist
antipki	anti pki
anugrah	anugerah
ap	_UNDF
apah	apa
apalikasi	aplikasi
apan	apa
apenista	penista
apk	apakah
apkabar	apa kabar
apkikasi	aplikasi
apl	aplikasi
aplg	apa lagi
aplgi	apa lagi
apli	aplikasi
aplikadi	aplikasi
aplikas	aplikasi
aplikasih	aplikasi
aplikasinnya	aplikasi
aplikasinya	aplikasi
aplikasinyaa	aplikasi
aplikasu	aplikasi
apliksi	aplikasi
apo	apa
appl	app
applikasi	aplikasi
appnya	app nya
apps	app
apr	_UNDF
aps	app
aq	aku
aqill	aqil
aquh	aku
ar	_UNDF
arabic	arab
arabiyyan	arab
arahakan	arahkan
artianya	artinya
artinx	artinya
artinya	artinya
artinya	artinya
arwendo	arswendo
asai	_UNDF
asalam	salam
asek	asyik
asem	asam
asik	asyik
asikk	asyik
asline	asli
asmarah	asmara
assalam	salam
assalamuallaikum	assalamualaikum
astaghfirullohal	astaghfirullah
astaghfirullohal aziim	astaghfirullah
asutenan	asu tenan
asuuu	asu
asuz	asus
asyek	asyik
asyir	basyir
atao	atau
atasa	atas
atauatau05atauatau0atauatau0	atau
atauatauatau	atau
atauatauatau201atauatau201atauatauatau201atauatau	atau
atauatauatauatau	atau
atauatauatauatauatauatauatauatauatauatau	atau
ataubikin	atau bikin
atauem	atau
ataufitnah	atau fitnah
atauhr	atau
ataukasus	atau kasus
ataukyaiatauustadz	atau kyai atau ustadz
ataus	atau
ateknya	anteknya
atep	atap
ati	hati
ati2	hati-hati
atit	sakit
ato	atau
atrubut	atribut
atu	satu
aturnuhun	hatur nuhun
atw	atau
auditmui	audit mui
aun	_UNDF
ava	_UNDF
awkard	awkward
awkeren	keren
awutawutan	awut
aya	ada
ayang	sayang
ayok	ayo
ayoo	ayo
ayosavepakahok	ayo save pak ahok
ayuk	ayo
az	_UNDF
aza	saja
azanya	azan nya
azas	azas
aze	saja
azha	saja
azza	saja
azzan	azan
baanngggeett	banget
babeh	babe
bac	baca
bacaalkuran	baca alquran
badjaterbukti	badja bukti
badjingan	bajingan
badjstimenang	badja pasti menang
bae	baik
baekin	baik
bagaiamana	bagaimana
bagaimnpun	bagaimana pun
bagimane	bagaimana
bagis	bagus
bagoez	bagus
bagud	bagus
bagun	bangun
bagusekali	bagus sekali
baguss	bagus
bagusss	bagus
bagussss	bagus
bagust	bagus
bagusx	bagusnya
bahasaambon	bahasa ambon
bahwasannya	bahwa
baiar	bayar
baidab	biadab
baiik	baik
baikk	baik
bain	baik
bajad	bejad
bajer	_UNDF
bakalan	akan
balaikota	balai kota
bale_LOL	_UNDF
bales	balas
balesan	balasan
balikin	balikkan
bamgget	banget
bandarq	bandar
bandingin	bandingkan
banga	bangsa
banged	banget
bangeeeeet	banget
bangeet	banget
bangeettt	banget
bangen	banget
bangett	banget
bangettt	banget
bangetttt	banget
bangsatin	bangsat
bangt	banget
bantuak	bentuk
bantuan	bantu
bantuanya	bantuan
bantuin	bantu
bantuk	bentuk
banun	bangun
banyakin	banyak kan
baperan	baper
barangsi	barang siapa
bararti	berarti
barengan	bareng
barol	_UNDF
baruak	beruk
baser	_UNDF
baso	bakso
baterei	baterai
bauu	bau
bawaan	bawa
bayangin	bayangkan
bayarin	bayar
bbas	bebas
bberapa	beberapa
bbr	_UNDF
bbrapa	beberapa
bbrp	beberapa
bbwapril	_UNDF
bc	baca
bcr	bicara
bcs	because
bct	bacot
bcz	because
bd	beda
bda	beda
bdan	badan
bdemokrasi	demokrasi
bdg	bandung
bdn	badan
bebalutkan	balut
bebeda	berbeda
beberpa	beberapa
beblessindonesia	bless indonesia
becanda	bercanda
bedoa	berdoa
bedua	berdua
beelum	belum
begimanapun	bagaimanapun
beik	baik
bejadi	bejad
bejuang	juang
bekasisah	bekasi sah
bekel	bekal
bekingin	beking
bekoar	koar
belajar	ajar
belbahaya	berbahaya
beliin	belikan
beliu	beliau
beljar	belajar
beljr	belajar
beljumpa	berjumpa
belkngn	belakang
bellum	belum
belom	belum
belon	belum
belpula	_UNDF
bembantu	membantu
bemberikan	memberikan
ben	_UNDF
benae	benar
benarataujujur	benar atau jujur
benarbenar	benar
benardisalahkan	benar disalahkan
benarin	benarkan
benarkan	benar
bener	benar
bener	benar
bener2	benar-benar
beneran	benar
beneratausalah	benar salah
benerein	benar
benerin	benarkan
beragama	agama
berantem	bertengkar
berarti	arti
berbahay	berbahaya
bercover	cover
berdo	doa
berdoaa	doa
berdsrkn	dasar
berenti	berhenti
berfikir	pikir
berfikirnya	pikir
bergandengtangan	gandeng tangan
bergengam	genggam
bergleria	bergerilya
bergoncang	guncang
berguna	guna
bergunahh	berguna
berharap	harap
berhenti	henti
berhsl	hasil
beribadah	ibadah
berijin	ijin
berindak	tindak
beritadan	berita
beritahukan	beri tahu
beritain	berita
beritany	berita
beritaterkini	berita kini
berjaln	jalan
berjamaahcoblospecinya	berjamaah coblos pecinya
berjlan	jalan
berjuangbersamaahok	juang sama ahok
berkacaberkacanya	kaca
berkacakaca	kaca
berkanfaat	bermanfaat
berkarir	karir
berkepentingan	penting
berkontrubusi	kontribusi
berktp	ktp
berkualitas	kualitas
berkwalitas	kualitas
berlalku	berlaku
berlu	perlu
bermamfaat	bermanfaat
bermanfaaat	bermanfaat
bermanfaan	bermanfaat
bermanfaat	manfaat
bermasalah	masalah
bermenfaat	bermanfaat
bermenpaat	bermanfaat
bermsalah	bermasalah
berrti	arti
bersalahbkcumakenafitnah	salah bk cuma kena fitnah
bersamaahok	sama ahok
bersamabelankri	sama bela nkri
bersikukuh	kukuh
bersileweran	berseliweran
berslh	salah
bersntakan	berantak
bersyukrlah	syukur
bersyukur	syukur
berteleransi	bertoleransi
berterimakasih	terima kasih
berterimakasihkah	terima kasih
bertheti	berhenti
bertjahaja	tjahaja
bertrima	terima
besalah	salah
besarin	besarkan
besarkan	besar
besoknangisjilid	besok tangis
betulin	betulkan
beye	sby
bg	bagi
bgai	bagai
bgaimana	bagai
bdg	_UNDF
bget	banget
bgi	bagi
bgini	begini
bgini	begini
bginian	begini
bgitu	begitu
bgks	bungkus
bgm	bagaimana
bgmana	bagaimana
bgmn	bagaimana
bgmna	bagaimana
bgmu	bagimu
bgn	bangun
bgng	bengong
bgni	begini
bgntdr	bangun tidur
bgs	bagus
bgt	_UNDF
bgtu	begitu
bgus	bagus
bhasil	hasil
bhatil	bathil
bhinekaan	bhineka
bhinekatunggalika	bhineka tunggal ika
bhinneka	bhineka
bhkan	bahkan
bhkn	bahkan
bhn	bahan
bhong	bohong
bhs	bahas
bhsn	bahasan
bhw	bahwa
bhwa	bahwa
bhy	bahaya
biadap	biadab
biarin	biarkan
biarkan	biarkan
biarpn	biarpun
biasaa	biasa
bib	habib
bibtang	bintang
bigot	bigot
bigotry	bigot
bigots	bigot
biiiasaaaaa	biasa
bijahiyarosul	bijahi ya rasul
bijimana	bagaimana
bijimane	bagaimana
bil	_UNDF
bilamana	bila mana
bilic	bilik
bingot	bigot
binsaa	binasa
biruadanya	biru adanya
bisaa	bisa
bissmillah	bismillah
bj	baju
bju	baju
bk	buku
bkal	bakal
bkan	bukan
bke	_UNDF
bkerja	bekerja
bkin	bikin
bkl	bakal
bkn	bukan
bkna	bukan
bknlah	bukanlah
bkr	bakar
bks	bungkus
bl	beli
blajar	belajar
blakng	belakang
bland	_UNDF
blanja	belanja
blaspheming	blasphemy
bleh	boleh
blg	bilang
blgnya	bilang nya
blh	boleh
bli	beli
blik	balik
blingsatanya	blingsatan
blits	blitz
bljar	belajar
bljr	belajar
blk	balik
blkg	belakang
blkng	belakang
blkngny	belakangnya
blm	belum
bln	bulan
blng	bilang
blngn	bilang
blo	_UNDF
blom	belum
blon	belum
bloonnya	bloon
bls	balas
blum	belum
blusukanahok	blusukan ahok
bnar	benar
bndg	bandung
bndr	bandar
bner	benar
bneran	benar
bnget	sangat
bngett	banget
bngks	bungkus
bngng	bingung
bngsa	bangsa
bngt	sangat
bngun	bangun
bnr	benar
bnrbnr	benar-benar
bnrn	benar
bntangnya	bintangnya
bntar	sebentar
bntr	sebentar
bnwa	_UNDF
bny	_UNDF
bnyaj	banyak
bnyak	banyak
bnyk	banyak
bnykin	perbanyak
bnykny	banyaknya
bnyknya	banyak
bo	_PRON
bobo	bobok
bodo	bodoh
bodoamatguepilihahok	bodoh amat aku pilih ahok
bodohin	bodoh
boer	_UNDF
bohir	_UNDF
bohongin	bohong
boikotairmatlsu	boikot air mata palsu
boikotdemokrasi	boikot demokrasi
boikotkompas	boikot kompas
boikotmediaindonesia	boikot media indonesia
boikotmetrotivu	boikot metro tipu
boikotmetrotv	boikot metrotv
boikotsamsung	boikot samsung
boikotsariroti	boikot sariroti
bokap	ayah
bole	boleh
bomb	bom
boong	bohong
bosen	bosan
bosjudi	bos judi
boskuh	bosku
bp	bapak
bpak	bapak
bpk	bapak
br	_UNDF
brada	berada
bragama	beragama
brahman	brahmana
brakhir	akhir
brangkat	berangkat
brani	berani
braniengembalikan	berani kembali
brantas	berantas
brarti	berarti
brasa	berasa
brati	berarti
braveheart	brave heart
bravoo	bravo
bray	_PRON
brbuat	berbuat
brdiri	berdiri
breake	break
breakingnew	break news
breakingnewssektorriil	breaking news sektor riil
brenang	berenang
brfoto	berfoto
brg	barang
brgkt	berangkat
brgna	berguna
brharap	harap
brhsl	berhasil
bribadah	beribadah
brikut	berikut
bringas	beringas
brisik	berisik
brita	berita
brjiwa	jiwa
brjln	berjalan
brjuang	juang
brkeliaran	keliar
brkfst	breakfast
brkpntingan	kepentingan
brkuasa	berkuasa
brkumandang	kumandang
brkwalitas	berkualitas
brlaku	laku
brmanfaat	bermanfaat
brmnfaat	bermanfaat
brmpt	empat
brmslh	bermasalah
brngkt	berangkat
bro	_PRON
broo	_PRON
brooo	_PRON
brp	berapa
brpa	berapa
brpedoman	pedoman
brpikir	berpikir
brrbuat	buat
brrti	berarti
brs	beres
brsal	berasal
brsalah	bersalah
brsama	bersama
brsamamu	bersamamu
brsatu	satu
brshbt	bersahabat
brsm	bersama
brsma	sama
brstu	satu
brsyukur	bersyukur
brt	berat
brtahan	bertahan
brtemu	bertemu
brthn	bertahan
brtindak	bertindak
brtmbah	bertambah
brtmn	berteman
bru	baru
bruh	buruh
brusan	barusan
bs	bisa
bsa	bisa
bsalah	bersalah
bsar	besar
bsgus	bagus
bsk	besok
bsok	besok
bsr	besar
bsrtambah	bertambah
bsrtamu	besertamu
bsuaralah	bersuaralah
btg	batang
bth	butuh
btl	betul
btpnwa	btp nwa
btul	betul
btull	betul
buad	buat
buagus	bagus
buat	buat 
buatin	buatkan
buayya	buaya
bubarin	bubar kan
bubarkanmui	bubar mui
bud	_UNDF
budha	buddha
budha	buddha
bugus	bagus
buiahok	bui ahok
bujjer	_UNDF
bukabukaan	buka
bukak	buka
bukane	bukannya
bukanmenjegal	bukan jegal
bukanstatusprovokasi	bukan status provokasi
bukn	bukan
buknpenistaagama	bukan nista agama
buktiin	bukti kan
buktikan	bukti kan
buktikqn	bukti kan
bukubaru	buku baru
bukugpu	buku gpu
bul	kibul
bulshit	bullshit
bungkamarogansiahok	bungkam arogan ahok
bungkammulutlancang	bungkam mulut lancang
buntikan	buktikan
burok	buruk
burukman	buruk man
buryam	bubur ayam
buu	ibu
buyasafiimaarif	buya syafii maarif
buzer	buzzer
buzzerahoaxsebarkanhoax	buzzer ahoak sebar hoax
buzzerbuzzernya	buzzer
buzzernya	buzzer
buzzernya	buzzer
buzzers	buzzer
bw	bawa
bwa	bawa
bwaanx	bawaan
bwah	bawah
bwahaha	_LOL
bwh	bawah
bwt	buat
byak	banyak
byangkan	bayangkan
byk	banyak
byk	banyak
bynk	banyak
byr	bayar
byrn	bayaran
cacimaki	caci maki
cagubdki	cagub dki
cagubnya	cagub
cagup	cagub
cahya	cahaya
cala	cara
calender	kalender
calma	calm
calonmantangubernur	calon mantan gubernur
cam	_UNDF
campaigns	campaign
campuri	campur
cangkeme	cangkem
cannot	can not
cant	can not
cantek	cantik
cape	capek
caper	cari perhatian
carane	caranya
cashback	cash back
caturx	caturnya
cawgub	cawagub
cb	coba
cbaan	cobaan
cc	_ETRA
cck	_EXCL
ceck	check
cedas	cerdas
ceheheheh	_LOL
cekeos	_UNDF
celebrit	celebrity
cem	macam
cemplungin	cemplung
cemungud	semangat
centuryataumuniratauhambalang	century munir hambalang
cepet	cepat
cepetan	cepat
cepetnya	cepat
ceppat	cepat
certa	cerita
cewe	cewek
cha	_UNDF
cheerss	cheer
china	cina
chinese	cina
chk	check
ciap	siap
ciayou	caiyo
cie	_EXCL
ciee	_EXCL
ciihh	_EXCL
cin	_PRON
cino	cina
cintainabi	cinta nabi
cintaindonesia	cinta indonesia
cintaiulama	cinta ulama
cintakeadilan	cinta adil
cintapolri	cinta polri
cintatanahair	cinta tanah air
cintatni	cinta tni
cintaulama	cinta ulama
citizens	citizen
citrapositif	citra positif
cius	serius
ciyan	kasihan
ciye	_EXCL
ciyus	serius
ckck	_EXCL
ckckck	_EXCL
ckp	cukup
ckrg	sekarang
ckup	cukup
clain	_UNDF
cm	cuma
cma	cuma
cman	cuma
cmn	cuma
cmpk	campak
cntoh	contoh
co	_UNDF
cobain	coba
cobeh	_UNDF
coblosno	coblos
coblospecinya	coblos pecinya
coboss	coblos
cocokk	cocok
coffe	coffee
coiii	_PRON
col	_UNDF
comeback	come back
coment	comment
con	_UNDF
congornyapecah	congor pecah
congrats	congratulation
conpressnya	konferensi pers
contak	kontak
contonya	contoh
controversial	controversy
coretahoksbgcagubdki	coret ahok bagai cagub dki
couldn	could not
counterny	counter
counterpart	counter part
countrywide	country wide
cowo	cowok
coyy	_PRON
coz	karena
cpat	cepat
cpet	cepat
cpt	cepat
cptn	cepat
cropan	crop
crt	cerita
crta	cerita
cs	_ETRA
cth	contoh
cuapcuap	cuap
cucok	cocok
cui	_PRON
cuih	_EXCL
cuihhhhhh	_EXCL
cukupsatuputaran	cukup satu putaran
cuman	cuma
cupon	kupon
curaanng	curang
curhatan	curhat
customerku	customer
customers	customer
cuy	_PRON
cw	cewek
cwe	cewek
cwo	cowok
cyberjihad	cyber jihad
cz	karena
da	dan
dach	sudah
dagri	dalam negeri
dah	sudah
dah	sudah
dak	tidak
dalah	adalah
dalama	dalam
dalangnye	dalang
dalat	daulat
dalem	dalam
damaidaricirebon	damai dari cirebon
damainkri	damai nkri
damay	damai
damsung	samsung
danain	dana
dann	dan
dannn	dan
dapet	dapat
dapetin	dapat
dapetinnya	dapatkan
dapt	dapat
dapurr	dapur
darimana	dari mana
daripada	dari pada
daripaddatidda	dari pada tidak
darkknight	dark night
dasz	_UNDF
datangin	datang
dateng	datang
daut	daud
dbca	dibaca
dbela	dibela
dblg	dibilang
dblkng	di belakang
dbls	dibalas
dbohongi	bohong
dbwt	dibuat
dbyr	dibayar
dde	_UNDF
ddpn	depan
de	_PRTL
deah	_EXCL
dealny	deal nya
debatfinalpilkadajkt	debat
december	desember
dech	_EXCL
dedicated	dedicate
dee	_EXCL
deehh	_EXCL
defamation	defame
defame	fame
defeated	defeat
defended	defend
definis	definisi
defuld	_UNDF
deket	dekat
deketin	dekati
deletefpi	delete fpi
deletemui	delete mui
dema	_UNDF
demean	_UNDF
demen	suka
democratic	democracy
democrazy	demokrasi
demodemo	demo
demodemonov	demo november
dengann	dengan
denger	dengar
dengerin	dengar
dengernya	dengar
dengn	dengan
denial	deny
depa	depan
depositoin	deposito
des	desember
desakn	desakan
desemberstory	december story
despiritualisasi	spiritual
deut	_UNDF
dewadewa	dewa
dftr	daftar
dg	dengan
dgn	dengan
dgr	dengar
dgrn	dengar
dh	_PRTL
dhalim	zalim
dhewan	dewan
dhlu	dahulu
dholim	zalim
dhukum	hukum
diaa	dia
diajakin	ajak
diajrkan	ajar
diajukn	aju
diancungi	acung
dianugrahi	anugrah
dianutny	anut
diaorangbenar	dia orang benar
dibaca	baca
dibanyakin	banyak
dibayar	bayar
dibelakanghari	belakang hari
dibeliin	beli
diberitain	berita
dibesarin	diperbesar
dibiarin	biar
diblg	di bilang
dibobongin	bohong
dibodohin	bodoh
dibohongin	bohong
dibohonginataudibodohin	bohong bodoh
dibohongipakainangis	bohong pakai tangis
diboongin	bohong
dibriefing	briefing
dibuatin	buat
dibuatx	buat
dibudigunawankan	budi gunawan
dibully	bully
dibunuhpakai	bunuh pakai
dicacimaki	caci maki
dichinakan	cina
diconto	contoh
dicuekin	cuek
dideketin	didekati
didekte	dikte
didenger	didengar
didengerin	didengarkan
didholimi	zalim
didiemin	diam
didki	dki
didlam	dalam
didlm	dalam
didoain	doa
didown	di down
didownload	di download
didzalimi	zalim
didzolimi	zalim
die	dia
diem	diam
diemin	diam
diff	differ
difikirin	pikir
difitna	fitnah
diftnah	difitnah
digembosin	gembos
diginiin	jadi begini
digituin	jadi begitu
digunain	guna
dihapus	hapus
dihmps	dihempas
dihp	di hp
dihpus	dihapus
dihukum	hukum
diijabah	ijabah
diijinkan	diijinkan
diijinkan	diizinkan
diijinkan	ijin
diikutsertakan	ikut serta
diingatkn	diingatkan
diinstall	di install
diintrogasi	diinterogasi
dijabarin	jabarkan
dijadiin	jadi
dijadikan	jadi
dijakarta	di jakarta
dijatohin	jatuh
dijatuhin	jatuh
dijatuhkan	jatuh
dijdkn	jadi
dijelasin	dijelaskan
dijelekin	dijelekkan
dijolimin	zalim
dijulukin	juluk
dikaburin	kabur
dikatain	kata
dikendaliin	dikendalikan
dikenyataanya	nyata
dikerasin	keras
dikerjain	kerja
dikirain	kira
dikit	sedikit
dikliminalisasi	kriminalisasi
dikoordinir	koordinir
dikrimialisasi	kriminalisasi
dikrimimalisasi	kriminalisasi
dikumpulin	kumpul
dikutip	kutip
dilak nati	dilaknati
dilakuin	laku
dilaporin	lapor
dilebelkan	dilabelkan
dilebihin	lebih
diliht	lihat
dilindes	lindas
diloading	di loading
dilupain	dilupakan
dim	dalam
dima	dimana
dimaafin	maaf
dimana	mana
dimane	mana
dimanfaatin	dimanfaatkan
dimasukin	masuk
dimasukkin	dimasukkan
dimbatin	batin
dimintain	minta
dimna	mana
dimonas	monas
dimonitoring	monitor
dimunculin	muncul
dinaikin	naik
dinegri	negeri
dingajikan	dikajikan
diobok	obok
diorang	dia orang
diorg	dia orang
dipakai	pakai
dipake	dipakai
dipantatin	pantat
dipantengin	panteng
dipemjara	penjara
dipemjara	penjara
dipenjaraatautersangka	penjara atau sangka
dipenjarain	penjara
diperbesar	besar
diperbnyak	banyak
diperhatiin	hati
diperjualbelikan	jual beli
diperjuangin	juang
dipernjarakan	penjara
diphpin	php
dipikirin	pikir
dipilkada	pilkada
dipinjemi	pinjam
dipitnah	fitnah
dipliara	pelihara
diplintir	plintir
dipolisitisir	politik
dipolitiking	politik
diporakporandakan	porak poranda
diprogress	di progress
diprose	proses
dipungkiri	mungkir
diputarbalikkan	putar balik
diragulan	ragu
dirasain	dirasakan
direbutin	rebut
direfresh	di refresh
dirinya	diri
dirix	diri
dirmh	di rumah
disadarin	sadar
disagree	agree
disakitin	sakit
disalahgunakan	salah guna
disamarinda	samarinda
disamsung	di samsung
disappointed	appoint
disaranin	saran
disbt	disebut
disetting	di setting
disewotin	sewot
disholatin	sholat
disingkirin	singkir
diskont	diskon
disp	display
distreaming	stream
disumbangin	disumbang
disumpahdisumpahin	sumpah
disumpahin	sumpah
disuruh	suruh
ditahan	tahan
ditanggapin	tanggap
ditawarin	ditawarkan
ditawarkan	tawar
ditayangin	tayang
ditegor	ditegur
ditembah	ditembak
ditemenin	ditemani
ditenga	tengah
ditentukn	tentu
ditetapin	tetap
ditetapknnya	tetap 
ditimbunin	timbun
ditinggiin	ditinggikan
ditps	tps
ditrsangkakan	sangka
dittapkn	tetap
ditukarkannya	tukar
ditunggangin	tunggang
dituntaskeun	tuntas
diturunin	turun
ditwiter	twitter
diupdate	di update
diupgrade	di upgrade
diurusin	diurusi
diwebnya	web
dizhalimi	zalim
dizholimi	zalim
dizolimi	zalim
djakarta	jakarta
djasatuputaran	satu putaran
djaterbukti	jakarta bukti
djkt	di jakarta
djl	di jalan
djln	di jalan
djlskan	jelas
djmin	jamin
dkat	dekat
dket	dekat
dket	dekat
dkg	dukung
dkijakarta	dki jakarta
dkls	di kelas
dkmps	di kampus
dkmr	di kamar
dkng	dukung
dkntr	di kantor
dksh	dikasih
dkt	dekat
dkung	dukung
dkungan	dukung
dkunganpositif	dukung positif
dl	dulu
dlam	dalam
dlapor	lapor
dliht	lihat
dlm	dalam
dlm	dalam
dlm dalam	dalam dalam
dlmnya	dalam
dlrng	dilarang
dlu	dulu
dluan	duluan
dmana	dimana
dmkn	dimakan
dmn	dimana
dmna	dimana
dmnmn	dimana-mana
dmny	dimananya
dmpk	dampak
dn	dan
dng	dengan
dngan	dengan
dngar	dengar
dnger	dengar
dngerin	dengar
dngn	dengan
dngr	dengar
dnyatakan	nyata
doaa	doa
doain	doa
doainahokdibui	doa ahok bui
doakanahok	doa ahok
doang	saja
doank	saja
does	do
doesn	do not
doi	dia
doing	do
doitnya	duit
don	do not
done	do
doneload	download
dongo	dungu
donk	_PRTL
donkk	_PRTL
donkkkk	_PRTL
donloand	download
donlot	download
donlowd	download
dont	do not
donwload	download
doong	_PRTL
dosadosa	dosa
dowlod	download
downloadnya	download
dpan	depan
dpat	dapat
dpengadilan	di pengadilan
dpengaturn	di pengaturan
dperangi	perang
dperbaharui	di perbaharui
dperlukan	perlu
dpermasalahkan	masalah
dpet	dapat
dpetinnya	dapatkan
dpi	_UNDF
dpk	depok
dpkai	dipakai
dpkrkn	dipikirkan
dpn	depan
dpnrmh	depan rumah
dppfpi	fpi
dprjlanan	di perjalanan
dpt	dapat
dpt	dapat
dptin	dapatkan
dr	dari
drajatnya	derajat
dramaahok	drama ahok
dramaahokdizalimi	drama ahok zalim
dramaahokterzalimi	drama ahok zalim
dramatic	drama
dreamer	dream
dreaming	dream
drh	darah
dri	dari
drmana	dari mana
drmh	di rumah
drmn	darimana
drpd	daripada
drtd	dari tadi
drumah	di rumah
dsb	dan sebagainya
dsblh	di sebelah
dsingkirkan	singkir
dsini	disini
dsklh	di sekolah
dsna	sana
dsni	di sini
dsnii	sini
dsr	dasar
dsrnya	dasarnya
dst	dan seterusnya
dsuruh	disuruh
dt	datuk
dtambah	tambah
dtetapkn	tetap
dtetk	tetap
dtg	datang
dtgn	datang
dtgny	datangnya
dtmbh	ditambah
dtmpt	di tempat
dtng	datang
dtrma	diterima
dttapkn	tetap
dtuduh	tuduh
dtukarkannya	ditukarkannya
dtuntut	tuntut
duabelas	dua belas
duaduanya	dua dua
duchh	_EXCL
duh	_EXCL
dukasih	duka
dukungahok	dukung ahok
dukungahokdjarot	dukung ahok djarot
dukungbadjasatuputaran	dukung badja satu putar
dukungfatwa	dukung fatwa
dukungfatwamui	dukung fatwa mui
dukungjaksaistiqomah	dukung jaksa istiqomah
duluan	lebih dulu
dulunya	dulu
dumay	dumai
dwmi	_UNDF
dwmo	_UNDF
dwonload	download
dy	dia
dya	dia
dzalim	zalim
dzalimi	zalim
dzhaliminya	zalim
dzikir	zikir
dzikirakbar	zikir akbar
dzolim	zalim
dzolimi	zalim
dzolimin	zalim
ea	ya
each	ya
eagles	eagle
ealah	ya lah
easily	easy
ech	_EXCL
ed	_UNDF
ee	_UNDF
eehh	_EXCL
eek	tahi
efforts	effort
efpei	fpi
egak	tidak
egh	_EXCL
ehem	_EXCL
ehh	_EXCL
ehm	_EXCL
eikeh	aku
eksepsiataupledoi	eksepsi atau pledoi
eksoduswncina	eksodus cina
elah	_EXCL
elas	belas
elech	_EXCL
elected	elect
elee	_EXCL
elektabilitasnya	elektabilitas
elektibilitas	elektabilitas
ellu	elu
elo	elu
emakemak	emak emak
eman	teman
emang	memang
emang	memang
emangnya	memangnya
emank	memang
embarrassing	embarrass
emg	memang
emm	_EXCL
emng	memang
emui	mui
en	dan
ending	end
endingnya	end
ends	end
engga	tidak
enggak	tidak
enggeusan	_UNDF
enjarakanahok	penjara ahok
enk	enak
enoh	emoh
entar	nanti
ente	anda
ente	kamu
entee	kamu
entitu	_UNDF
equityworld	equity world
eradication	eradicate
eran	_UNDF
erka	rk
erte	RT
erti	mengerti
esbeye	sby
eskrim	es krim
esmosi	emosi
ethnicity	ethnic
etikat	etiket
euy	_EXCL
eventually	event
everythings	everything
everytime	every time
experiences	experience
expestasi	ekspektasi
exploitasi	eksploitasi
facebooker	facebook
faces	face
facrbook	facebook
faham	paham
fahami	pahami
fahir	fahira
failed	fail
fairest	fair
faktaahokdiserang	fakta ahok serang
fanati	fanatik
fanbase	fan base
fans	fan
fansboy	fan boy
fatwamui	fatwa mui
fb	facebook
fcked	fuck
fears	fear
feb	februari
feeling	feel
feto	veto
fibohongi	bohong
fid	god
fightahok	fight ahok
fightback	fight back
fighter	fight
fightforahok	fight for ahok
fighting	fight
fights	fight
fightwithahok	fight with ahok
figuran	figur
fihancurkan	hancur
fikir	pikir
fikiran	pikir
finah	fitnah
financially	financial
finding	find
fingers	finger
finished	finish
fir aun	firaun
firmanallah	firman allah
fiturnya	fitur nya
fiykum	fikum
fkus	fokus
flowing	flow
fokeh	OK
fokushukumahok	fokus hukum ahok
fokushukumpenista	fokus hukum nista
fokushukumpenistaagama	fokus hukum nista agama
fokushukumppenista	fokus hukum nista
fokuskasusahok	fokus kasus ahok
fokuspenistaagama	fokus nista agama
fokuspenjarakanahok	fokus penjara ahok
fokustangkhok	fokus tangkap ahok
foll	follow
follback	follow back
follbek	follow back
followback	follow back
follower	follow
followers	follow
follows	follow
foloow	follow
fonsel	ponsel
fonts	font
foods	food
fouder	found
fpibersamarakyat	fpi sama rakyat
framed	frame
framing	frame
fraudsters	fraud
freeahok	free ahok
freebies	free
freenya	free
friends	friend
fsilitas	fasilitas
fsiq	fasik
ftv	ftv
fuck	fuck
fuckin	fuck
fuckyou	fuck you
fuih	_EXCL
fullfil	full
fully	full
furnished	furnish
futures	future
fv	_UNDF
ga 	tidak
gaada	tidak ada
gabakal	tidak akan
gabisa	tidak bisa
gaboleh	tidak boleh
gacuma	tidak Cuma
gada	tidak ada
gadapet	tidak dapat
gaenak	tidak enak
gafok	tidak fokus
gagalin	gagalkan
gagalkan	gagal
gaikut	tidak ikut
gais	_PRON
gajadi	tidak jadi
gajahmada	gajah mada
gajelas	tidak jelas
gak	tidak
gak	tidak
gakelar	tidak kelar
gakk	tidak
gakuat	tidak kuat
galaxygift	galaxy gift
galo	galau
gamasuk	tidak masuk
gamau	tidak mau
gameoverahok	game over ahok
games	game
gamuncul	tidak muncul
gan	_PRON
ganbate	semangat
gangerti	tidak mengerti
gans	_PRON
gantirezim	ganti rezim
gantisistem	ganti sistem
ganyangahok	ganyang ahok
ganyangcina	ganyang cina
gapedulisamastatus	tidak peduli status
gapedulisamastatustersangka	tidak peduli sama status sangka
gapercaya	tidak percaya
gapernah	tidak pernah
gapunya	tidak punya
garangangarangan	garang
gardaaamiin	garda amin
gardaislami	garda islam
gardamaya	garda maya
garem	garam
gass	gas
gasuka	tidak suka 
gatakut	tidak takut
gatau	tidak tahu
gatel	gatal
gausa	tidak usah
gausah	tidak usah
gawe	kerja
gaye	give
gb	_UNDF
gbr	gambar
gbt	lgbt
gbuahok	gbu ahok
gc	begitu
gdg	gudang
gebukin	gebuk
gedein	gede
gegara	gara
gelaja	gejala
gelarperkarasudahdiumumkan	gelar perkara sudah umum
gem	_UNDF
gembel	jelek
gemes	gemas
gendheng	gendeng
gene	begini
gengs	geng
genk	geng
genks	geng
genkz	geng nya
gentleman	gentle
gentlemen	gentle
gera	gerak
gerakansalat	gerak shalat
gerakanshalatsubuhberjamaah	gerak shalat subuh jamaan
gerakanshubuhberjamaah	gerak subuh jamaah
gerakansubuhberjamaah	gerak subuh jamaah
gerja	gereja
getting	get
gezutt	_UNDF
gg	tidak
ggi	_UNDF
ggl	gagal
ggn	_UNDF
ggs	gagas
ghift	gift
giblok	goblok
giftnya	gift nya
gifts	gift
gilaaaaaaa	gila
gilak	gila
gilaran	giliran
gile	gila
gilee	gila
giliaran	gilir
giliran	gilir
gilla	gila
gils	_UNDF
gimana	bagaimana
gimanapun	bagaimana
gimanasih	bagaimana 
gin	gini
ginian	begini
gitchu	gitu
gitu	begitu
gituan	begitu
gituh	begitu
gituloh	gitu
gituu	gitu
given	give
gives	give
giving	give
gk	tidak
gk	tidak
gke	tidak pakai
gla	gila
glorify	glory
glorious	glory
gm	_UNDF
gmana	bagaimana
gmbr	gambar
gmn	bagaimana
gmna	bagaimana
gmpg	gampang
gmpng	gampang
gni	begini
gnpfmui	gnpf mui
gnti	ganti
goals	goal
gobanannya	uang
goblog	goblok
godbless	god bless
godblessindonesia	gos bless indonesia
godsaveindonesia	god save indonesia
godsavejakarta	god save jakarta
goes	go
going	go
gojakarta	go jakarta
golfut	golput
goliat	goliath
goncangan	guncang
gone	go
gonna	go
gos	_UNDF
gosipin	gosip
goublog	goblok
gov	gubernur
govenors	governor
governed	govern
government	govern
governo	gubernur
governoor	gubernur
governor	gubernur
governors	governor
governour	gubernur
govt	government
goyangin	goyang kan
gp	tidak apa
gpa	tidak -
gpalah	tidak  lah
gpe	tidak 
gpeduli	tidak peduli
gpl	tidak pakai lama
gplah	tidak apalah
gpny	tidak punya
gpp	tidak -
gpplah	tidak  
gprnh	tidak pernah
gr	gara
gr2	gara-gara
gramed	gramedia
gratisan	gratis
grdmy	_UNDF
gregetan	gemas
greja	gereja
grgr	_EXCL
grj	gereja
grombolannya	gerombolannya
grounded	ground
growth	grow
grt	great
grtis	gratis
grtisn	gratis
gruduk	geruduk
gsr	gusur
gt	begitu
gt	begitu
gtis	gratis
gtu	begitu
gtw	tidak tahu
gua	saya
gubatauwalkot	gubernur walikota
gubenur	gubernur
guberenur	gubernur
gubernurbuzzer	gubernur buzzer
gubernus	gubernur
gubraaaaak	gubrak
guburnur	gubernur
gue	saya
gueahok	aku ahok
guebersamaahok	aku sama ahok
guemewek	saya tangis
guilty	guilt
gunain	gunakan
guoblok	goblok
gur	_UNDF
gurbenur	gubernur
guritacikeas	gurita cikeas
guwe	gue
guweh	aku
guy	guy
guy	_PRON
guys	guy
gw	saya
gws	get well soon
gx	tidak
h	_UNDF
ha	_LOL
haahahahahah	_LOL
habaib	habib
habi	_LOL
habibfpi	habib fpi
habibrizieqsyihab	habib rizieg shihab
habibur	habib
habiburohman	habiburrohman
habieb	habib
habiskan	habis
habits	habit
hacur	hancur
hadapi	hadap
hadapin	hadap
hadeh	aduh
hadeuh	aduh
hadeuuh	aduh
hadia	hadiah
hadist	hadits
hadist	hadits
hadist	hadits
haditsnya	hadist nya
haduh	aduh
hadwal	jadwal
haha	_LOL
hahaa	_LOL
hahaha	_LOL
hahahaa	_LOL
hahahaha	_LOL
hahahahaa	_LOL
hahahahah	_LOL
hahahahaha	_LOL
hahahahahaha	_LOL
hahahahha	_LOL
hahahahhahaa	_LOL
hahahh	_LOL
hahahha	_LOL
hahahhahaha	_LOL
hahhahha	_LOL
hakekat	hakikat
halangin	halang
haluszs	halus
handodno	handono
hands	hand
hanyaahok	hanya ahok
hape	handphone
happened	happen
happening	happen
happens	happen
hapusairmata	hapus air mata
hapusfbi	hapus fpi
haq	hak
haramhrtirmidzi	haram tirmidzi
harampemimpinkafir	haram pimpin kafir
harampilihahok	haram pilih ahok
hardest	hard
hardliners	hardline
hardship	hard
harianx	hari
hariharimu	hari
harini	hari ini
haritoleransi	hari toleransi
haritoleransiinternasional	hari toleransi internasional
haritoleransinasional	hari toleransi nasional
harku	harap
harusnya	harus
hary	harry
hasilnya	hasil
hasilnyabtapi	hasilnya tapi
hastag	hashtag
hastage	hashtag
hasteg	hashtag
hateful	hate
hatei	hti
hater	hate
haters	hater
hatersnya	hater
hatespeech	hate speech
hatinye	hati
hatred	hate
hatters	hate
having	have
hayal	hayal
hayuk	ayo
hayuuk	ayo
hbd	happy birthday
hbis	habis
hbng	hubungi
hbngn	hubungan
hbs	habis
hbskn	habiskan
hdup	hidup
healing	heal
hearts	heart
hebatny	hebatnya
hebatsangat	hebat sangat
hebatx	hebat
heeeew	_EXCL
heh	_LOL
hehe	_LOL
hehehe	_LOL
hehehehe	_LOL
hehehhe	_LOL
helow	halo
helpfull	helpful
helping	help
hemm	_EXCL
henfon	handphone
hepi	senang
hepihepinya	senang
hepinya	happy
hera	heran
hereeee	_EXCL
heroic	hero
hestag	hashtag
hestagnya	hashtag
hesteg	hashtag
hesteg	hashtag
hestegnya	hashtag
hestek	hashtag
heu	_EXCL
hg	_UNDF
hgg	sehingga
hian	_UNDF
hidayahna	hidayah
hidupahok	hidup ahok
hidupgwselo	hidup saya santai
higher	high
hihihi	_LOL
hihiy	_LOL
hikma	hikmah
hiks	SAD
hikss	SAD
hikum	hukum
hilangin	hilang
hilangngkan	hilang
hindalilah	hindar
hing	_UNDF
hirmati	hormat
hitamkn	hitam
hitzfmschoolbattle	school battle
hj	haji
hkm	hukum
hkum	hukum
hl	hafal
hlg	hilang
hlm	halaman
hlmn	halaman
hmbalang	hambalang
hmm	_EXCL
hny	hanya
hny	hanya
hnya	hanya
hoak	ahoak
hoaker	ahoaker
hoakers	ahoaker
hoek	ahok
hog	ahoak
hohoho	_LOL
hok	ahok
hok	ahok
homenya	home nya
honestly	honest
honesty	honest
hookk	ahok
hopefully	hope
hopeless	hope
hormatin	hormat
hotels	hotel
hours	hour
hows	how
hox	ahoak
hpku	hp ku
hpnya	hp nya
hps	hapus
hr	hari
hrduser	hrd user
hrg	harga
hrgny	harganya
hri	hari
hrn	harn
hrp	harap
hrs	harus
hrs	harus
hrsny	harusnya
hrsnya	harus
hru	haru
hrus	harus
hrusnya	harusnya
hruz	harus
hsl	hasil
ht	hati
hti	hati
htnya	hatinya
hu	_EXCL
huah	_EXCL
huakbar	allah akbar
hub	hubung
hubungan	hubung
hubunganya	hubung
hubungn	hubungan
hucu	lucu
huehehe	_LOL
huehue	_LOL
huehuehue	_LOL
huha	_LOL
huk	_EXCL
hukumahok	hukum ahok
hukumanny	hukum
hukumanny	hukum
hukumharustegak	hukun harus tegak
hukumpenghinaulama	hukum hina ulama
hukumpenistaagama	hukum nista agama
hukumpenistaalquran	hukum nista alquran
hukumpenistaquran	hukum nista alquran
hukun	hukum
hukun	hukum
humanity	human
humanity	human
humm	_EXCL
hur	_UNDF
hurufnya	huruf
hurufx	hurufnya
husuk	khusuk
hutqn	hutan
huuu	_EXCL
huwallohu	allah
hv	have
hwahahaha	_LOL
hwahahahah	_LOL
hy	hanya
iamwithahok	with ahok
ibdah	ibadah
idelete	delete
idiots	idiot
idolnya	idol
idung	hidung
idup	hidup
ig	_UNDF
igat	ingat
ignoble	_UNDF
ihat	lihat
ihlas	ikhlas
ihuser	user
ii	_UNDF
ijin	izin
ijinkan	ijin
ijo	hijau
ik	_UNDF
iket	ikat
ikhwana	ikhwan
iki	ini
iklanahokjahat	iklan ahok jahat
iku	ikut
ikutikutan	ikut
ikutin	ikut
ilah	lah
ilang	hilang
ilangnya	hilang
illahi	allah
iloveu	love
im	_UNDF
imagine	image
imambesarfpi	imam besar fpi
imambesarnasional	imam besar nasional
imbau	himbau
imembela	bela
imperfections	perfect
impianindonesia	impian indonesia
imposible	impossible
improvement	improve
imwith	with
imwithahok	with ahok
ind	indonesia
indakk	tidak
independen	independent
indikasikorupsirsswlahancengkarengdanasiluman	indikasi korupsi rssw lahan cengkareng dana siluman
indo	indonesia
indo	indonesia
indon	indonesia
indoneisia	indonesia
indonesa	indonesia
indonesi	indonesia
indonesiaamantanpaahok	indonesia aman tanpa ahok
indonesiaberadab	indonesia adab
indonesiabersatu	indonesia satu
indonesiabhineka	indonesia bhineka
indonesiabhinneka	indonesia bhineka
indonesiacareerexpo	indonesia career expo
indonesiadamai	indonesia damai
indonesiadamaitanpabasuki	indonesia damai tanpa basuki
indonesiadamaitanpapenistaagama	indonesia damai tanpa nista agama
indonesiakerja	indonesia kerja
indonesian	indonesia
indonesians	indonesia
indonesiaraya	indonesia raya
ingatkan	ingat
inget	ingat
ingetin	ingatkan
ingetnya	ingat
ingnikan	ingin
ingsa	_UNDF
ingt	ingat
ini~>:FAKTA	ini fakta
inibarujakarta	ini baru jakarta
inideh	ini
inih	ini
inil	ini
inilh	ini
inimasalahpenistaan	ini masalah nista
initi	inti
injek	injak
injustice	justice
innocense	innocent
inoleran	intoleransi
inregritas	integritas
insa	insya
insaalloh	insyaallah
insallah	insya allah
insha	insya
inshaa	insya
inspired	inspire
inspiring	inspire
instal	install
insya allah	insyaallah
insyaa	insya
insyaaallah	insya allah
insyaallah	insya allah
insyaallah	insya allah
insyaallah	insya allah
insyaalloh	insya allah
insyaflah	insyaf
insyallah	insya allah
intended	intend
intergritas	integritas
internationally	international
internetan	internet
internetnya	internet nya
intruksi	instruksi
iostoconahok	ahok
iq	iq
ironic	iron
isa	bisa
isalm	islam
isla	islam
islambangkit	islam bangkit
islamcintabhineka	islam cinta bhineka
islamic	islam
islamiccenter	islam center
islamisthebest	islam best
islamofacist	islam facist
islamrahmatanlilalamin	islam rahmat
islamtoleran	islam toleran
islamwayoflife	islam way life
isma	risma
isnt	not
iso	bisa
issu	isu
issue	isu
issues	isu
istandwithahok	stand with ahok
isterimu	istrimu
istrht	istirahat
istrisaya	istri saya
isusara	isu sara
item	hitam
its	it
itself	it self
ituh	itu
itukami	itu kami
itumah	itu
itung	hitung
iuh	_UNDF
ive	have
iy	iya
iyaa	ya
iyah	ya
iyahhh	ya
iye	ya
iyoo	iya
ja	saja
jabaninn	jaban
jabatanya	jabat
jadiah	hadiah
jadiin	jadi
jadijadian	jadi jadi
jadikn	jadi
jadwan	jadwal
jagan	jangan
jagankr	jaga nkri
jagankri	jaga nkri
jagarta	jakarta
jagncasila	jaga pancasila
jajirah	jazirah
jak	jakarta
jakarda	jakarta
jakart	jakarta
jakartaadalahahok	jakarta ada ahok
jakartaamantanpaahok	jakarta aman tanpa ahok
jakartaatauluar	jakarta atau luar
jakartabanjir	jakarta banjir
jakartabaru	jakarta baru
jakartaberdoa	jakarta doa
jakartabutuhahok	jakarta butuh ahok
jakartakece	jakarta kece
jakartaku	jakarta
jakartalebihbaik	jakarta lebih baik
jakartamu	jakarta
jakartan	jakarta
jakartanya	jakarta
jakartauntukrakyat	jakarta untuk rakyat
jakrt	jakarta
jakrta	jakarta
jaksabukanpengacaraahok	jaksa bukan pengacara ahok
jaksahebat	jaksa hebat
jaksaistiqomah	jaksa istiqomah
jala	jalan
jama	jamaah
jamaan	jamaah
jamaat	jemaat
jambaner	jamban
jambaners	jambaner
jambans	jamban
jambanya	jamban
jang	jangan
jangam	jangan
janganadalagigusuran	jangan ada gusur
jangangembiradulu	jangan gembira dulu
jangangolput	jangan golput
janganhanyaahok	jangan hanya ahok
janganmalasbaca	jangan malas baca
janganmaudibohongiahok	jangan mau dibohongi ahok
janganmaudibohonginpakai	jangan mau bohong pakai
janganmaudibohongipakaiairmata	jangan mau bohong pakai air mata
janganmaudibohongipakaikatatersangka	jangan mau bohong pakai kata sangka
janganmenagislagi	jangan tangis lagi
jangannangislagi	jangan tangis lagi
jangas	jangan
jangn	jangan
janjijokowi	janji jokowi
janjikapolri	janji kapolri
janten	_UNDF
jarna	karena
jarot	djarot
jatoh	jatuh
jatohnya	jatuhnya
jatuhataumundur	jatuh mundur
jatuhin	jatuh
jatuhkn	jatuh
jau	jauh
jawban	jawab
jd	jadi
jdi	jadi
jdkan	jadi
jdny	jadinya
jdnya	jadinya
jdwl	jadwal
jebloskanbasukimasukbui	jeblos basuki masuk bui
jeje	_UNDF
jejek	jelek
jelasmenistaagama	jelas nista agama
jelassalah	jelas salah
jelekin	jelek
jelk	jelek
jem	jam
jenegan	kamu
jentelman	gentleman
jer	_UNDF
jernikan	jernih
jesica	jessica
jesika	jessica
jesika	jessica
jeungkelin	jengkel
jf	_UNDF
jg	juga
jg	juga
jga	juga
jgak	juga
jgan	jangan
jglh	jagalah
jgn	jangan
jgnjgn	jangan-jangan
jgnkan	jangan
jgnlah	jangan
jgnn	jangan
jgoan	jagoan
jiah	_EXCL
jian	ujian
jihadcyber	jihad cyber
jik	jika
jiwaa	jiwa
jiwaaa	jiwa
jizah	jizyah
jjs	_UNDF
jjur	jujur
jjurnnya	jujur
jk	jika
jka	jika
jkarta	jakarta
jkrt	jakarta
jkrta	jakarta
jksa	jaksa
jksaagung	jaksa agung
jkt	jakarta
jkta	jakarta
jkw	jokowi
jl	jalan
jl	jalan
jlg	jalan
jlgajahmada	jalan gajah mada
jln	jalan
jlnku	jalan
jlnmu	jalan
jls	jelas
jm	jam
jmbtn	jembatan
jml	jumlah
jmlh	jumlah
jmpt	jemput
jmt	jumat
jng	jangan
jngan	jangan
jnganlah	janganlah
jnglah	janganlah
jngn	jangan
jodo	kalijodo
jogja	jogjakarta
jogjakarta	yogyakarta
joined	join
jokodok	joko
jokowiahok	jokowi ahok
jokowiatauahok	jokowi atau ahok
jokowibersamarakyat	jokowi sama rakyat
jokowihormatihukum	jokowi hormat hukum
jokowin_ETRAl	jokowi n_ETRAl
jokowipecatahok	jokowi pecat ahok
jokowipenuhijanji	jokowi penuh janji
jokowitaklindungiahok	jokowi tidak lindung ahok
jokowitakutfpi	jokowi takut fpi
jokowiterbuktiadil	jokowi bukti adil
jolimi	zalim
jomblowers	jomblo
jongon	jangan
joob	job
joozzz	joss
jos	joss
josstenan	joss tenan
jozz	joss
jpn	jepang
jpu	jaksa
jreeng	jreng
jrg	jarang
jrng	jarang
jt	juta
jubirnya	jubir
judulnye	judul
jugaa	juga
jugha	juga
jungkirbalik	jungkir balik
junjunganya	junjung
jur	_UNDF
juruslamat	juru selamat
justiceforahok	justice for ahok
justrudukungahok	justru dukung ahok
jutru	justru
jwb	jawab
jwbn	jawaban
jwbny	jawabannya
kaai	kami
kaatau	atau
kabar	kabar
kacaux	kacau
kacida	kasih
kadamg	kadang
kafirun	kafir
kafr	kafir
kaga	tidak
kagak	tidak
kagakkkkk	tidak
kahh	kah
kahwatir	khawatir
kaka	kakak
kakakangkat	kakak angkat
kalahin	kalah
kalao	kalau
kalaun	kalau
kale	kali
kalean	kalian
kalee	kali
kaleee	kali
kaleeeee	kali
kalena	karena
kalendar	kalender
kaliangoblok	kalian goblok
kaliiii	kali
kalik	khalik
kalikk	kali
kalo	kalau
kalok	kalau
kalrnder	kalender
kalu	kalau
kamiahhok	kami ahok
kamiaho	kami ahok
kamiahok	kami ahok
kamiahokk	kami ahok
kamiahokkamu	kami ahok 
kamialumni	kami alumni
kamibersamaahok	kami sama ahok
kamibersamatemanahok	kami sama teman ahok
kamibmuslim	kami muslim
kamibukan	kami bukan
kamibukan	kami bukan
kamibukanahok	kami bukan ahok
kamicintadamai	kami cinta damai
kamicintaindonesia	kami cinta indonesia
kamiindonesia	kami indonesia
kamikamukitadanmereka	kami kamu kita mereka
kamilaumni	kami alumni
kamimanusia	kami manusia
kamimasihahok	kami masih ahok
kamimuslim	kami muslim
kaminegarahukum	kami negara hukum
kaminyahok	kami ahoak
kamitethok	kami tetap ahok
kamitidaktakut	kami tidak takut
kammi	kami
kampany	kampanye
kampanyeahokjahat	kampanye ahok jahat
kampanyee	kampanye
kampanyesara	kampanye sara
kampenye	kampanye
kampunhan	kampung
kamuahok	kamu ahok
kamucebongjamban	kamu cebong jamban
kandangin	kandang
kandangkanahok	kandang ahok
kandangkanbasuki	kandang basuki
kapolribelasi	kapolri bela si
kapolritahanahok	kapolri tahan ahok
kapolritangkhok	kapolri tangkap ahok
kaporli	kapolri
karbitan	karbit
karepmu	karep mu
karepmulah	karep mu lah
karirmu	karir
karna	karena
karno	sukarno
karoke	karaoke
kasalndukung	kasal dukung
kash	kasih
kasi	kasih
kasian	kasihan
kasiih	kasih
kasusahok	kasus ahok
kasusrssw	kasus rssw
kasusunya	kasus
kat	_UNDF
katakantidakuntukahok	kata tidak untuk ahok
katatan	kata
katholik	katolik
kati	berkat
katohlik	khatolik
katongahok	katong ahok
katulungan	ketulungan
kau	kamu
kaun	kaum
kawalahok	kawal ahok
kawalfatwamui	kawal fatwa mui
kawalkasusahok	kawal kasus ahok
kawalkasusahox	kawal kasus ahoak
kawall	kawal
kawalpengadilanahok	kawal adil ahok
kawalproseshukumahok	kawal proses hukum ahok
kawaltegakhukum	kawal tegak hukum
kawalterus	kawal terus
kawanahok	kawan ahok
kawatirmu	khawatir
kayak	mirip
kayake	kayak
kayaknya	kayak
kayane	kayak
kayanya	kayaknya
kbaca	baca
kbenaran	benar
kbencian	kebencian
kbesaran	besar
kblingerz	keblinger
kbnaran	benar
kbneran	benar
kbnran	benar
kbnrn	benar
kbnykan	banyak
kbnykn	kebanyakan
kbr	kabar
kbtln	kebetulan
kburu	buru
kbusukan	busuk
kbykn	kebanyakan
kcewa	kecewa
kcil	kecil
kdepan	depan
kdg	kadang
kdng	kadang
kdpn	ke depan
keadilanhukum	adil hukum
keadilanmilikkaumyangterzalimi	adil milik kaum yang zalim
keadilanya	keadilan nya
keapjjang	kepanjangan
kebanggan	kebanggaan
kebangkitanislam	bangkit islam
kebathilan	batil
kebawa	terbawa
kebenaram	benar
kebenaranbyg	benar
kebenran	benar
kebereraniammu	berani
keberserahdirian	berserah diri
kebershinan	bersih
kebhinekaan	bhineka
kebhinnekaan	bhineka
kebhinnekaannya	bhineka
kebiadban	kebiadaban
kebncian	benci
kecakepan	kecakn
kecamatan	camat
kecengin	keceng
kedapaatan	dapat
kedaulatannkriterancam	daulat nkri ancam
kedengeran	terdengar
kedholiman	zalim
kedzaliman	zalim
kedzoliman	zalim
keepcalm	keep calm
keepp	keep
keeps	keep
kege	_UNDF
kegeeran	gede rasa
kehabisan	habis
kehabisn	kehabisan
kehe	_UNDF
kehimpit	himpit
keiknya	kayak
kejadia	jadi
kejahatankejahatannya	jahat
kejakarta	ke jakarta
kejaksaanri	jaksa 
kejaliman	zalim
kekanak	anak
kekecewan	kecewa
keknya	sepertinya
kekuasaa	kuasa
kekuatanya	kuat
kelakson	klakson
kelan	kelam
kelaperan	kelran
kelar	selesai
kelarloehok	kelar ahok
kelen	kalian
keliatan	kelihatan
kelici	licik
kelles	kali
keluarg	keluarga
keluarin	keluar
kelurahan	lurah
kemagama	kemenag
kemanain	mana
kemanapun	mana
kemane	kemana
kemaren	kemarin
kembaliataurevisi	kembali atau revisi
kembalikeuud	kembali uud
kembangin	kembang
kemen	kementerian
kemenagama	kemenag
kemeterian	kementerian
kemnangan	kemenangan
kemping	camping
kemunapiqan	kemunafikan
kemunkaran	kemungkaran
kenapaa	kenapa
kenape	kenapa
kenceng	kencang
kencengin	kencangkan
kenegarawan	negarawan
kenersihan	kebersihan
kenicahyaan	keniscayaan
kenyataanya	kenyataan nya
kepaeat	_UNDF
kepaslon	ke paslon
kepastianhukum	kepastian hukum
kepntingn	kepentingan
kepolpuleran	kepopuleran
keq	_EXCL
kereen	keren
kerenn	keren
keretakn	keretakan
kerjaaan	kerjaan
kerjanyata	kerja nyata
kerjasama	kerja sama
kerna	karena
keroyokan	keroyok
kesalahanya	kesalahan nya
kesampean	kesampaian
kesangkut	tersangkut
kesel	kesal
kesemoatan	kesempatan
kesian	kasihan
keslaahan	kesalahan
ketangkep	tertangkap
ketdk	ke tidak
ketengangan	ketegangan
keterangannya	keterangan nya
keteranganya	keterangan nya
keterpukukan	terpuruk
keterttinggalan	tertinggal
ketidakadilan	tidak adil
ketidakbenaran	tidak benar
ketidakbersalahan	tidak salah
ketifr	_UNDF
ketinggalan	tinggal
ketka	ketika
ketulungan	tolong
ketutunan	keturunan
keujanan	kehujanan
kewren	keren
kezholiman	kezaliman
kezoliman	kezaliman
kga	tidak
kgak	tidak
kgk	tidak
kh	kah
khabar	kabar
khabar	kabar
khan	kan
khidupan	kehidupan
khlas	ikhlas
khongfutze	konghucu
khonghucu	konghucu
khsny	khususnya
khwtr	khawatir
kiblatx	kiblatnya
kicaupulitik	kicau politik
kinerjaahok	kinerja ahok
kinlatnya	_UNDF
kirain	kira
kirimin	kirimkan
kitaa	kita
kitaahok	kita ahok
kitabelumkalah	kita belum kalah
kitadukung	kita dukung
kitadukungahok	kita dukung ahok
kitasemuaahok	kita semua ahok
kite	kita
kito	kita
kjahatan	kejahatan
kk	kakak
kkk	kakak
kkuasaan	kekuasaan
kl	kalau
klau	kalau
klh	kalah
kli	kali
klian	kalian
kliarga	keluarga
kliatan	kelihatan
kliatannya	lihat
kliatn	lihat
klihatan	lihat
klmat	kalimat
klmpk	kelompok
klo	kalau
klok	_EXCL
klompok	kelompok
kloning	cloning
klp	kelompok
klran	_UNDF
klrg	keluarga
kls	kelas
klu	kalau
kluar	keluar
kluarga	keluarga
klw	kalau
km	kamu
kmaren	kemarin
kmari	ke mari
kmarin	kemarin
kmbali	kembali
kmbing	kambing
kmenangn	menang
kmi	kami
kmn	kemana
kmna	kemana
kmnapun	kemana pun
kmps	kampus
kmr	kamar
kmren	kemarin
kmrin	kemarin
kmrn	kemarin
kmu	kamu
kmunduran	mundur
kn	kan
kna	kena
knahok	_UNDF
knapa	kenapa
kndidatku	kandidatku
knl	kenal
knp	kenapa
knpa	kenapa
knpaa	kenapa
knri	nkri
kntr	kantor
knyng	kenyang
ko	_UNDF
kodekeras	kode keras
koentji	kunci
kog	_EXCL
kohahok	ahok
kokam	_UNDF
kokek	_UNDF
komemtar	komentar
komen	komentar
komersil	komersial
kompetebel	compatible
kompia	_UNDF
kompleks	komplek
komtak	_UNDF
koncox	konconya
konekai	_UNDF
konfrensi	konferensi
konsen	konsentrasi
konsititusi	konstitusi
konslet	korslet
konsolidasidewanpkb	konsolidasi dewan PKB
konstitusionalitas	konstitusi
konten	content
konter	konten
konvirasi	konspirasi
koord	koordinator
kopas	copas
kopon	kupon
koq	_EXCL
koq	_EXCL
korbaninn	korbankan
koropsi	korupsi
koroptor	koruptor
korputor	koruptor
kosan	kost
kosentrasi	konsentrasi
kotrak	kontrak
koupon	kupon
kouptor	koruptor
kouta	kuota
koyo	kayak
kp	kampung
kpala	kepala
kpan	kapan
kpann	kapan
kpd	kepada
kpda	kepada
kpdmu	pada
kpdnya	pada
kpgn	ingin
kpkbidikmui	kpk bidik mui
kpklamban	kpk lamban
kpkmemble	kpk memble
kpktebangpilih	kpk tebang pilih
kpkusutahok	kpk usut ahok
kpn	kapan
kpngn	ingin
kpntingan	penting
kputusan	putus
krban	korban
krbelakang	ke belakang
kredibility	credibility
kren	keren
krena	karena
kresten	kristen
krg	kurang
krik	_EXCL
kriminalisasiataufitnah	kriminalisasi atau fitnah
kriminallisasi	kriminalisasi
kriminilisasi	kriminalisasi
kristian	kristiani
krja	kerja
krjaan	kerja
krmh	ke rumah
krn	karena
krna	karena
krng	kurang
krnkebanykn	karena banyak
krtu	kartu
krupsi	korupsi
kruptor	koruptor
krupuk	kerupuk
ksalahan	kesalahan
ksana	ke sana
ksel	kesal
ksh	kasih
ksian	kasihan
ksih	kasih
kslian	kalian
ksmptn	kesempatan
ksn	_UNDF
kss	_UNDF
ksus	kasus
kt	kita
kta	kita
ktauan	tahu
ktdrn	ketiduran
ktemu	ketemu
ktika	ketika
ktinggalan	ketinggalan
ktk	ketika
ktm	ketemu
ktmpt	ke tempat
ktmu	ketemu
ktny	katanya
ktnya	katanya
ktr	kantor
ktrhubungn	terhubung
kualitasnyaaa	kualitasnya
kuansing	_UNDF
kulsub	kuliah subuh
kultiwiit	kuliah tweet
kumpulann	kumpulan
kumpulanya	kumpulannya
kurg	kurang
kurng	kurang
kurnialillah	kurnia allah
kurungahok	kurung ahok
kurungahokdalamwc	kurung ahok dalam wc
kurungin	kurung
kut	_UNDF
kuu	_PRON
kuy	_UNDF
kw	_UNDF
kwajiban	kewajiban
kwal	kawal
kwan	kawan
kwi	_UNDF
kwl	kawal
kwn	kawan
ky	kayak
kya	_UNDF
kyak	kayak
kyaknya	kayak nya
kyanya	kayak nya
kyk	kayak
kykny	kayak nya
kyknya	kayak nya
kyny	kayak nya
laah	_PRTL
labgsung	langsung
laen	lain
laf	_PRTL
lag	lagi
lagian	lagi
lahh	_PRTL
lakban	lakban
laknatuloh	laknat
lakuin	lakukan
lalajo	_UNDF
lalin	lalu lintas
lalu lintas	lintas
lalulintas	lalu lintas
lamaaa	lama
lamaaaa	lama
lambungkaan	lambung
lambungkan	lambung
lambungkeun	lambung
lan	_UNDF
landasannya	landasan
landasannya	landasan
landasanya	landasan
langsg	langsung
lanjoot	lanjut
lanjutjakartabaru	lanjut jakarta baru
lanjutkangnpf	lanjut gnpf
lanjutken	lanjut
lanjutkeun	lanjut
lanjutt	lanjut
lansung	langsung
lantangnatas	lantang
lanutkan	lanjutkan
laper	lapar
laporin	laporkan
laskarbanyuwangi	laskar banyuwangi
laskarcyber	laskar cyber
latepost	late post
lau	elu
lawa	lawan
lawankapitalisme	lawan kapitalisme
lawankomunisme	lawan komunis
lawanlawannya	lawan
lawannya	lawan
lb	lembar
lbh	lebih
lbih	lebih
lc	_UNDF
lebarankuda	lebaran kuda
lebihbanyk	lebih banyak
lemes	lemas
lemoot	lemot
lemot	lambat
lengkao	lengkap
lets	let us
lewatin	lewat
leye	leyeh
lg	lagi
lgh	lagi
lgi	lagi
lgian	lagi
lgkp	lengkap
lgs	langsung
lgsg	langsung
lgsng	langsung
lgsug	langsung
lgsung	langsung
lgtp	lagi tapi
lgunya	lagu
lh	_PRTL
lha	_EXCL
lhaa	_EXCL
lhat	lihat
lho	_EXCL
lht	lihat
liad	lihat
liat	lihat
liatin	lihat
lindungitokohisla	lindung tokoh
lindungitokohislam	lindung tokoh islam
lisanatauaksi	lisan atau aksi
lisanny	lisan
lisannya	lisan
listrikk	listrik
lkukan	lakukan
ll	will
lm	lama
lmbaga	lembaga
lmbt	lambat
lmyn	lumayan
lndasan	landasan
lngkh	langkah
lngkp	lengkap
lngsg	langsung
lngsng	langsung
lngsung	langsung
lnjt	lanjut
lnsg	langsung
lnsng	langsung
lo	elu
loadingny	loading nya
loadingnya	loading nya
loadingy	loading nya
loding	loading
loe	elu
loh	_EXCL
lohh	_EXCL
_LOL	_LOL
_LOLa	loading lama
loph	love
lorang	_UNDF
lott	lot
loudingnya	loading nya
lounching	launching
lovee	love
loverx	love
lpngn	lapangan
lpr	lapar
lsg	langsung
lslam	islam
lt	_UNDF
lu	elu
luarbiasa	luar biasa
luass	luas
luh	kamu
luh	lu
lumayab	lumayan
lumayn	lumayan
lupain	lupa
lurahataucamat	lurah camat
lus	_UNDF
luu	kamu
luuuuuuaaarrrrrrrrr	luar
lvl	level
lw	kamu
lwan	lawan
lwn	lawan
lwt	lewat
lying	lie
lyk	layak
maa	_UNDF
maaci	terima kasih
maacih	terima kasih
maafin	maaf
mabok	mabuk
mabu	mabuk
macem	macam
macul	pacul
maen	main
maenan	mainan
mafaatkan	manfaat
mah	_PRTL
mahamengetahui	maha tahu
mahendr	mahendradatta
mahluk	makhluk
mahokers	ahoker
maidah	almaidah
majid	masjid
majority	major
majuin	maju
majuterusahok	maju terus ahok
majuteruspantangmundur	maju terus pantang mundur
majuu	maju
makah	_UNDF
makana	karena itu
makane	maka
makanin	makan
makanmakannya	makan
makanya	maka
makanya	maka
makanye	maka
makarallah	makar allah
makaru	makar
makasi	terima kasih
makasih	terima kasih
makasihhh	terima kasih
make	pakai
make	pakai
maker	make
makes	make
makincintaahok	makin cinta ahok
makirin	parkir
maklym	maklum
makmak	emak emak
makn	makan
maksa	paksa
maksain	paksa
maksdnya	maksud
maksih	terima kasih
maksimall	maksimal
maksudnya	maksud
maksutnya	maksudnya
malahnantanginumatislam	malah tantang umat islam
malem	malam
malem2	malam
malesdemolagi	malas demo lagi
malming	malam minggu
maluin	malu
malumaluin	malu
mamam	makan
mamatikan	mati
mambantu	membantu
mambiadabkan	membiadabkan
mamen	_UNDF
mampet	mampat
mamputetapi	mampu tetapi
mampuuss	mampus
mampuuuusssssss	mampus
manaatausi	mana
manang	menang
manasan	panasan
mandak	mandek
mandel	mandella
mandela	mandella
mandellanya	mandella
mane	mana
maneh	mana
manggil	panggil
mangtaff	mantap
maning	sangat
mano	mana
mantaap	mantap
mantab	mantap
mantabb	mantap
mantabs	mantap
mantaf	mantap
mantaff	mantap
mantag	mantap
mantal	mantap
mantapp	mantap
mantappp	mantap
mantaps	mantap
mantau	pantau
manteman	teman
mantengin	panteng
mantep	mantap
mantsp	mantap
manusiya	manusia
manythanks	many thank
mao	mau
maoo	mau
marabahaya	bahaya
marahdia	marah
marahin	marah
marawis	marawis
marawisnya	marawis nya
mariberdoa	mari doa
maritegakkankonstitusi	mari tegak konstitusi
markhotop	markotop
martyr	martir
masakin	masakan
masalahagamamasalahserius	masalah agama masalah serius
masalalu	masa lalu
masang	pasang
masangnya	pasang nya
masangx	pasang nya
masayarakat	masyarakat
mascot	maskot
mash	masih
masihahok	masih ahok
masiih	masih
masive	massive
masjidil	mesjid
masukin	masukkan
masukkan	masuk
masy	masyarakat
masyaaalloh	masyaallah
masyarakan	masyarakat
masyarkat	masyarakat
masyrakat	masyarakat
matahati	mata hati
matakaki	mata kaki
matamh	mata
matanajwadebatjakarta	matanajwa
mateng	matang
materil	materi
matielah	mati
matiin	mati
matimatian	usaha keras
matters	matter
matuwlohi	allah
maunya	mau
mautersangka	mau sangka
mauyang	mau yang
max	maximum
mayan	lumayan
maybe	may be
mb	mbak
mbangun	membangun
mbantah	membantah
mbantu	membantu
mbedain	beda
mbelain	bela
mbenerin	benar
mberi	beri
mberikan	beri
mbiadabkan	membiadabkan
mbingungi	bingung
mbleeseek	mblesek
mblo	_PRON
mbo	_PRON
mboten	tidak
mbuang	membuang
mbuat	buat
mbuh	_EXCL
mbunuh	membunuh
mburi	_UNDF
mburimu	belakang
mca	_UNDF
mcm	macam
mct	macet
mdesak	desak
mdg	lebih baik
mdgn	baikan
mdh	mudah
mdorong	mendorong
mdpt	dapat
mdukung	dukung
mdungukan	dungu
means	mean
mebantu	membantu
mecah	pecah
medeka	merdeka
mediskreditkan	diskredit
medukung	dukung
medukungmu	dukung
megingat	mengingat
meilhat	lihat
meingkatkan	tingkat
mejegel	_UNDF
melahirkn	melahirkan
melaksanakan	laksana
melaksanakn	melaksanakan
melambah	melambat
melambat	lambat
melambungatautop	lambung atau top
melangar	langgar
melatiuser	melati user
melencehkan	leceh
melihara	pelihara
melihatataumenyaksikan	lihat saksi
melihatny	lihat
melotot	lotot
melototin	lotot
melulu	selalu
melupakan	lupa
melwn	lawan
memafkannya	maaf
memakainya	memakai
memamg	memang
memanjakan	manja
membaca	baca
membadja	badja
membalikkn	balik
membanthu	membantu
membantu	bantu
membantuu	membantu
membanyu	membantu
memberikan	beri
members	member
membntu	membantu
membri	beri
membtu	membantu
membuktiken	bukti
membumihanguskan	bumi hangus
memdem	pendam
memecahbelah	pecah belah
memeddiehard	memed diehard
memenagi	menang
memenanglkan	menang
memg	memang
memilh	pilih
memilih	pilih
memimpn	pimpin
memjkn	maju
memkasakan	memaksakan
memontum	momentum
mempelajarinya	ajar
mempelajarix	mempelajarinya
memperitimbagkan	timbang
memperjuangakan	juang
mempermaslahkan	masalah
mempertanggungjawabkan	tanggung jawab
memporakporandakan	porak poranda
mempressure	tekan
mempromote	promote
memyukai	menyukai
menagama	mentri agama
menagis	tangis
menagkanislam	menang islam
menange	menang
menangin	menang
menangkanislam	menang islam
menangsatuperiode	menang satu periode
menangsatuputaran	menang satu putar
menatasnamakan	atas nama
menayukuri	mensyukuri
menbangun	bangun
menbantu	membantu
mencampuradukkan	campur aduk
mendadakpakaiquran	dadak pakai alquran
mendingan	lebih baik
mendo	doa
mendonload	men download
mendonlot	download
mendowload	men download
mendownload	men download
mendzolimi	zalim
meneruss	terus
menfitnah	fitnah
meng	_UNDF
mengahadang	hadang
mengajarkn	mengajarkan
mengaji	kaji
menganalisa	analisa
menganggu	ganggu
mengantrakan	mengantarkan
mengatakn	mengatakan
mengataskamakan	atas nama
mengatasnamakan	atas nama
menge	_UNDF
mengetahui	tahu
menggu	_UNDF
menggunakan	guna
menggunggah	unggah
menghadang	hadang
menghalangmenghalangi	halang
menghayal	hayal
menghi	_UNDF
menghimbau	himbau
menghujatataumemprovokasi	hujat atau provokasi
mengigat	mengingat
mengingatkn	mengingatkan
menginginkanbk	ingin bk
menginstal	men install
mengispirasi	inspirasi
mengjar	kejar
menguatkanya	kuat
mengugurkan	gugur
mengumrohkan	umroh
mengumumkam	umum
mengupload	upload
menindaklanjuti	tindak lanjut
menistkan	nista
menitihkan	titik
menitikberatkan	titik berat
menizta	nista
menjadi	jadi
menjalan	jalan
menjalankan	jalan
menjalimin	zalim
menjarain	penjara
menjatuhkanya	jatuh
menjatukannya	jatuh
menjawad	jawab
menjd	jadi
menjdikan	jadi
menjdkn	jadi
menjlnkan	menjalankan
menjugde	judge
menkadi	jadi
menndakan	menandakan
menodakn	noda
menolaksara	tolak sara
mensoaialisasikan	sosial
mentiagakan	tiada
menwrpa	terpa
meny	me
menyakini	yakin
menyalahgunakan	salah guna
menyatakn	nyata
menyebarluaskan	sebar luas
menyelamaykan	selamat
menyempatkan	sempat
menyesal	sesal
menyukai	suka
menzolimi	zalim
merampot	rampok
merapihkan	rapi
merasakn	rasa
merespon	jawab
mereview	review
merhatiin	memperhatikan
meridhoi	ridho
merintahkan	perintahkan
meris	miris
merka	mereka
meronrong	rongrong
mersakan	rasa
mesen	pesan
mesih	masih
mesjit	mesjid
metrotipu	metro tipu
mghadapi	hadap
mghargai	harga
mgk	mungkin
mgkin	mungkin
mgkn	mungkin
mgunakan	guna
mh	_UNDF
mha	_UNDF
mhn	mohon
mhon	mohon
mhs	mahasiswa
mhsw	mahasiswa
mhujat	hujat
mikir	pikir
mikirin	memikirkan
milih	pilih
milihat	lihat
milihkan	pilih
milihnya	pilih
millions	million
milyaran	milyar
milyran	milyar
mimbarny	mimbar
mimpin	pimpin
min	admin
minds	mind
mingir	pinggir
mingkin	mungkin
minjem	pinjam
minoritaa	minority
minutes	minute
miriss	miris
miskiin	miskin
missed	miss
mistakes	mistake
mjadi	jadi
mjaga	jaga
mjawab	menjawab
mjd	jadi
mjelaskan	menjelaskan
mk	maka
mk	maka
mka	maka
mkan	makan
mkanan	makanan
mkanya	makanya
mkin	makin
mklum	maklum
mkn	makan
mknan	makanan
mkny	maka itu
mknya	makanya
mksa	paksa
mksd	maksud
mksdny	maksudnya
mksdnya	maksudnya
mksdq	maksudku
mksh	terima kasih
mksih	terima kasih
mkstnya	maksud
ml	_UNDF
mlah	malah
mlainkan	melainkan
mlancarkan	lancar
mlarang	melarang
mlawan	lawan
mlayu	melayu
mlewati	lewat
mlh	malah
mlihatmu	lihat
mlm	malam
mls	malas
mlulu	melulu
mlut	mulut
mmang	memang
mmanjakan	memanjakan
mmb tu	bantu
mmb tu	_UNDF
mmb tu	_UNDF
mmbaca	membaca
mmbantu	membantu
mmbawa	bawa
mmbca	membaca
mmbeda	beda
mmbencii	benci
mmberi	beri
mmbla	bela
mmbntu	membantu
mmbodohi	bodoh
mmbohongi	bohong
mmbuat	buat
mmbuktikan	bukti
mmg	memang
mmikirkan	pikir
mmiliki	milik
mminta	pinta
mmng	memang
mmotivasi	memotivasi
mmprovokasi	provokasi
mn	mana
mna	mana
mnafik	munafik
mnang	menang
mnbaca	membaca
mncabut	cabut
mncatat	catat
mnci	_UNDF
mncium	cium
mnciutkan	ciut
mndatang	datang
mndengar	dengar
mndg	lebih baik
mndgn	lebih baik
mndgr	mendengar
mndi	mandi
mnding	lebih baik
mndpt	dapat
mndptkn	dapat
mndukng	dukung
mndukung	dukung
mndukungmu	dukung
mnebar	tebar
mnenangkn	tenang
mnerima	terima
mnetapkan	tetap
mng	menang
mngajarkan	mengajarkan
mngapresiasi	apresiasi
mngatasnamakn	atas nama
mngenal	kenal
mngetahui	mengetahui
mnggmbarkan	gambar
mnggunakn	menggunakan
mnghalangi	halang
mnghdapi	hadap
mnghemat	hemat
mnghilang	hilang
mnghna	hina
mnghukumny	hukum
mngikuti	mengikuti
mngingatkan	mengingatkan
mngira	kira
mngkin	mungkin
mnglhkn	kalah
mngnal	mengenai
mnicptakn	menciptakan
mnista	nista
mnjadi	jadi
mnjadikan	jadi
mnjaga	jaga
mnjalan	menjalan
mnjatuhkan	jatuh
mnjd	jadi
mnjdi	jadi
mnjtuhkan	jatuh
mnkoplhukam	menkopolhukam
mnkumham	menkumham
mnmptkn	tempat
mnng	menang
mnolak	tolak
mnrt	menurut
mnsyirikkan	mensyirikkan
mnt	minta
mnta	minta
mntp	mantap
mnum	minum
mnunggu	tunggu
mnuntun	menuntun
mnurunkan	turun
mnusia	manusia
mnyatu	satu
mnyayangkn	sayang
mnyelamatkn	selamat
mnyempatkan	menyempatkan
mnyentuh	sentuh
mnyerah	serah
mnyngkn	menyenangkan
mo	mau
modusbanget	modus banget
moduz	modus
modyare	mati
moeslem	moslem
moga	semoga
moga	semoga
mogax	semoga
mohammad	muhammad
mojok	pojok
molaik	mulai
moncer	lancar
mone	money
moneyrush	rush money
monitoring	monitor
monorit	_UNDF
moodnya	mood
moody	mood
moslems	moslem
moslim	moslem
mosok	masa
mostpopular	most popular
motong	potong
movementkegot	move
movie	movie
movies	movie
moving	move
mowo	_UNDF
mpo	_PRON
mprataudpr	mpr atau dpr
mrangkak	rangkak
mrasa	rasa
mrbtp	btp
mrebak	merebak
mreka	mereka
mrh	marah
mrk	mereka
mrka	mereka
mrmbgun	membangun
mrtad	murtad
msak	masak
msalah	masalah
msg	masing
msh	masih
msi	masih
msih	masih
msjid	mesjid
msk	masuk
msk	masuk
mski	masuk
mskipn	meski
mskn	masakan
msl	misal
mslah	masalah
mslh	masalah
mst	mesti
msti	harus
msuk	masuk
msuport	dukung
msyarakat	masyarakat
muatanya	muat
mucul	muncul
mudahhan	mudah
mudahmudahan	mudah
mudhn	mudah
mugi	semoga
muhamamd	muhammad
muhammadiyahinggris	muhammadiyah inggris
muji	puji
muke	muka
mukeje	muka jelek
mukinlah	mungkin
mulau	mulai
mulsim	muslim
multiwarna	multi warna
mulu	terus
mulutjamban	mulut jamban
mulutmuharimaumu	mulut harimau
mulutny	mulut
mulutrusakbasukiditolak	mulut rusak basuki tolak
muluttoilet	mulut toilet
munafij	munafik
munafikun	munafik
munafiq	munafik
munafiqun	munafik
munafq	munafik
muncuk	muncul
munculah	muncul
munculah	muncul
mundukung	dukung
murotalnya	murotal nya
murtadz	murtad
musholah	musholla
muslimbangkit	muslim bangkit
muslimbersatu	muslim satu
muslimcerdas	muslim cerdas
muslimcyberarmy	muslim cyber army
musliminaa	muslim
muslimjaya	muslim jaya
musnahkn	musnah
musti	harus
mustinya	harus
musuhmusuhnya	musuh
musuhx	musuh
muter	putar
muterr	putar
mutusin	memutuskan
mutuskan	putuskan
mw	mau
mwnguntungkan	menguntungkan
myampaikan	sampai
mygovernor	governor
mz	mas
n	_UNDF
naba	_UNDF
nabung	tabung
nacional	nasional
naek	naik
naekm	naik
nafsir	tafsir
nafsirin	tafsir
nagara	negara
nahan	tahan
nahkan	_EXCL
nahu	tahu
namaya	namanya
nambah	tambah
nambahin	tambah
nampaknya	tampaknya
nanaknya	anak
nanganin	tangani
nangis	tangis
nangiss	tangis
nanrtam	_UNDF
nantangin	tantang
nantik	nanti
nantj	nanti
nanya	tanya
nape	kenapa
napsu	nafsu
nari	tari
narik	tarik
naro	letakkan
nasgor	nasi goreng
nashroni	nasrani
nasibungkus	nasbung
natar	tatar
nati	nanti
nationalism	nation
nations	nation
nbela	bela
nd	_UNDF
nda	tidak
ndak	tidak
ndakk	tidak
ndakp	tidak 
ndasmu	ndas
ndendam	dendam
ndesonya	ndeso
ndesoooo	ndeso
ndesooooooo	ndeso
ndiri	diri
ndk	tidak
ndukung	dukung
ndul	_UNDF
ne	ini
nebar	nobar
nebarkan	tebarkan
nebayot	_UNDF
nech	ini
neeh	ini
neehh	ini
negar	negara
negaraa	negara
negarany	negara
nego	negosiasi
negri	negeri
negriku	negeri
neh	ini
nekan	tekan
neko	macam
nekoneko	macam
nelen	telan
nelesnya	ngeles nya
nemenin	temani
nemu	temu
nenangin	tenangkan
nengok	tengok
nerima	terima
nerimo	terima
netes	tetes
netizens	netizen
neverwalkalone	never walk alone
nex	next
nextnya	next
ng	_UNDF
nga	tidak
ngabela	bela
ngabisin	habiskan
ngaca	kaca
ngaceng	_UNDF
ngacir	lari
ngaco	kacau
ngadain	mengadakan
ngadepin	hadap
ngadu	adu
ngahok	ahoker
ngajak	mengajak
ngajakin	ajak
ngajar	ajar
ngajarin	ajar
ngajarkan	ajarkan
ngaji	kaji
ngajih	mengaji
ngajuin	aju
ngak	tidak
ngakak	terbahak-bahak
ngakali	akal
ngaku	aku
ngakunya	aku
ngalah	kalah
ngalahin	kalah
ngalahkan	kalah
ngalamin	alami
ngalir	alir
ngambek	marah
ngambil	ambil
ngamuk	amuk
ngancam	ancam
ngancem	ancam
nganggur	anggur
nganiaya	aniaya
nganter	antar
nganterin	antar
ngantri	antri
nganu	anu
ngaplkeun	_UNDF
ngarep	mengharap
ngarepin	harap
ngaruh	pengaruh
ngasi	kasih
ngasih	kasih
ngatain	kata
ngatakan	mengatakan
ngatasi	atasi
ngatur	atur
ngawal	kawal
ngawasi	awas
ngawur	ngawur
ngawurnya	ngawur
ngbantuin	bantu
ngebacot	bicara
ngebales	balas
ngebedain	beda
ngebela	bela
ngebelain	bela
ngeberisikin	berisik
ngebimbing	membimbing
ngebom	bom
ngebuka	buka
ngecek	cek
ngedapetinnya	dapat
ngedit	edit
ngedonlotin	men download
ngedukung	dukung
ngeekspresiin	mengekspresikan
ngefek	efek
ngegosip	gosip
ngegusur	gusur
ngeh	tahu
ngehadepin	hadap
ngehina	hina
ngejaga	menjaga
ngejar	kejar
ngejatuhin	jatuh
ngejebak	jebak
ngejek	ejek
ngejelekin	jelek
ngejilat	jilat
ngejorokin	menjorokkan
ngejuznya	juz nya
ngelakuin	melakukan
ngelakuinnya	laku
ngelarang	larang
ngelawan	lawan
ngelenggang	lenggang
ngelepas	melepas
ngeles	bicara
ngelewati	lewat
ngeliat	lihat
ngeliatin	melihat
ngeluarin	keluar
ngeluh	keluh
ngelupain	melupakan
ngemeluk	memeluk
ngemeng	omong
ngena	kena
ngepret	kepret
ngeramein	ramai
ngerasa	merasa
ngerasain	merasakan
ngerecokin	recok
ngerjain	mengerjakan
ngerokok	merokok
ngerti	mengerti
ngerti	mengerti
ngerubah	merubah
ngerusak	rusak
ngestalk	stalk
ngetik	ketik
ngetrend	trend
ngetweet	tweet
ngetwit	tweet
ngg	_UNDF
ngga	tidak
nggak	tidak
ngganggu	ganggu
nggenah	genah
nggk	tidak
ngi	_UNDF
ngidam	idam
ngik	_UNDF
ngikngikngik	_UNDF
ngikutin	ikuti
ngilangin	menghilangkan
ngimpi	mimpi
ngin	_UNDF
ngina	hina
ngincer	incar
nginep	menginap
ngingatkan	mengingatkan
ngingatken	ingat
ngingetin	mengingatkan
ngiri	iri
ngisin	malu
ngitung	hitung
ngjk	mengajak
ngk	tidak
ngkak	_LOL
ngkoh	engkoh
nglanturz	lantur
nglawan	lawan
nglirik	lirik
nglunjak	ngelunjak
ngmbil	ambil
ngmbl	mengambil
ngmg	omong
ngmng	berbicara
ngmpl	berkumpul
ngmps	ke kampus
ngntk	mengantuk
ngntr	ke kantor
ngobarkan	kobarkan
ngobatin	obati
ngobrol	bicara
ngoceh	oceh
ngok	_UNDF
ngomel	omel
ngomong	bicara
ngomonge	bicara
ngomongin	membicarakan
ngopi	kopi
ngorek	korek
ngosan	ngos
ngotorin	kotor
ngotot	otot
ngrasa	rasa
ngri	ngeri
ngrti	mengerti
ngrusak	rusak
ngucapin	ucap
ngulang	ulang
ngumpet	umpet
ngumpul	kumpul
ngundang	undang
ngunduh	unduh
ngundurin	mundur
ngungsi	ungsi
ngunpulin	kumpul
ngunu	sesuatu
ngunyah	kunyah
ngupload	upload
nguras	kuras
ngurus	urus
ngurusi	urusi
ngurusin	urus
ngusik	usik
ngusilin	usil
ngusir	usir
ngutip	kutip
nh	_EXCL
ni	ini
nich	ini
nie	ini
nih	ini
nihh	_EXCL
nii	ini
niiihhhh	ini
nikmaatt	nikmat
nikmatin	nikmat
nimbulin	timbul
ninggalin	tinggalkan
nisata	wisata
nitip	titip
niy	ini
njenengan	kamu
njing	anjing
njir	_PRON
nkriantikomunis	nkri anti komunis
nkridaruratchina	nkri darurat cina
nkrihargamati	nkri harga mati
nlayan	nelayan
nm	nama
nmbh	tambah
nmeng	me
nmn	namun
nmny	namanya
nmpk	nampak
nmr	nomor
nmun	namun
nn	_UNDF
nnt	nanti
nnti	nanti
nntinya	nanti
nntn	nonton
nnton	nonton
nntonnya	nonton
nobarahokdjarot	nobar ahok djarot
nocomment	no comment
noh	ini
nolak	tolak
nolong	tolong
nomorkoruptor	nomor koruptor
nonas	_UNDF
nong	_PRON
nonggol	nongol
nongkie	nongkrong
nongkrongi	tongkrong
nonjol	tonjol
nonop	_UNDF
nonton	tonton
nontonnya	tonton
noticx	notice
notif	notify
notifnya	notif
nov	november
novnovnov	november
nowdays	nowaday
nraktir	traktir
nrani	nurani
ns	nafas
nselain	selain
ntah	entah
ntap	mantap
ntar	nanti
ntar	nanti
ntdk	tidak
nte	kamu
nti	nanti
ntidak	tidak
ntinggal	tinggal
ntn	nonton
nton	nonton
ntr	nanti
ntu	itu
ntuk	untuk
nty	nanti
nuker	tukar
nulis	tulis
numbers	number
numpang	tumpang
numpuk	tumpuk
nunduk	tunduk
nunggu	tunggu
nungguin	tunggu
nunjuk	tunjuk
nunjukin	tunjuk
nuntut	tuntut
nuooo	_EXCL
nurunin	turun
nurut	turut
nuruti	turut
nvr	never
ny	nya
ny	s
nyaa	nya
nyadarin	sadari
nyagub	cagub
nyagubataujadi	cagub atau jadi
nyahok	ahoker
nyahoq	ahoker
nyakitin	menyakiti
nyaksiin	menyaksikan
nyalahin	menyalahkan
nyalain	nyalakan
nyalon	calon
nyalonin	calon
nyama	sama
nyambung	sambung
nyambungin	sambungkan
nyampaikan	menyampaikan
nyampe	sampai
nyampeinnya	sampaikan
nyampenya	sampainya
nyang	yang
nyangka	sangka
nyantai	santai
nyapres	capres
nyari	cari
nyasar	kesasar
nyasarr	kesasar
nyatany	nyata
nyatuin	satukan
nye	nya
nyebarin	sebar
nyebarkan	sebarkan
nyebelin	menyebalkan
nyebur	cebur
nyebut	sebut
nyegat	cegat
nyelesain	selesai
nyelip	selip
nyembah	sembah
nyembeli	sembelih
nyembunyiin	sembunyi
nyenengin	senang
nyengir	cengir
nyerah	serah
nyerang	serang
nyesal	sesal
nyesek	sesak
nyesel	menyesal
nyetel	setel
nyiapin	siap
nyiksa	menyiksa
nyimak	simak
nyimpang	menyimpang
nyindir	sindir
nyingkirin	singkir
nyiptain	cipta
nyiyir	nyinyir
nyoba	coba
nyobain	coba
nyoblos	coblos
nyogok	sogok
nyolong	colong
nyontek	contek
nyubitin	cubit
nyuci	cuci
nyumbang	sumbang
nyundul	sundul
nyunsep	nyungsep
nyuri	curi
nyuruh	suruh
nyusul	susul
nyusup	susup
nyuwun	suwun
oalah	oh
oantas	pantas
oatau	atau
oatau	atau
oataupolri	atau polri
odds	odd
offers	offer
ofline	offline
ogeb	bego
ohh	oh
ojo	ojo
ok	ok
okay	ok
okee	ok
okeh	ok
okesiip	ok sip
okt	oktober
ol	online
olang	orang
olh	oleh
olo	allah
omg	_EXCL
omongn	omong
omonng	omong
ones	one
onlinenya	online
opened	open
opinion	opini
opo	apa
opportunis	oportunis
optimism	optimis
optimistic	optimis
optimisx	optimis
opurtunis	opportunist
ora	tidak
orange	orang
orangenya	orange
orangorang	orang
orangx	orang
orangyangtidak	orang yang tidak
orenken	_UNDF
org	orang
org2	orang
orgbaik	orang baik
orgjahat	orang jahat
orgnya	orang
orgtua	orangtua
orng	orang
orngbaik	orang baik
otang	orang
ou	_UNDF
oun	pun
outletnya	outlet nya
ow	_EXCL
pa	pak
paakk	pak
pacarin	pacar
pacasila	pancasila
padahalkoruptor	padahal koruptor
padahl	padahal
pade	pada
pahami	paham
pait	pahit
pakafif	pak afif
pakahok	pak ahok
pakataubuk	pak atau ibu
pakay	pakai
pake	pakai
pakein	pakai
pakek	pakai
pakjokowidibullyahoker	pak jokowi bully ahoker
pakk	pak
pakkk	pak
paklebarankuda	pak lebaran kuda
pakprihatin	pak prihatin
pakUSER	USER
palagi	apa lagi
palalu	kepala kamu
palawan	pahlawan
palestine	palestina
palikasi	aplikasi
pamerin	pamer
pamjang	panjang
panasbug	panasbung
pancagila	pancasila
panggilanuntukberjuang	panggil untuk juang
pant	_UNDF
pantasila	pancasila
pantengin	panteng
pantes	pantas
pantesan	pantas
pantesnya	pantas
paraah	parah
paradikma	paradigma
parapenyusup	para susup
parasites	parasit
paraulama	para ulama
parents	parent
parties	partai
paska	pasca
pasty	pasti
pasu	palsu
payahhhhhhhhhhhhhh	payah
pcar	pacar
pcetar	_UNDF
pcr	pacar
pcrn	pacaran
pcrny	pacarnya
pcs	_UNDF
pd	pada
pda	pada
pdahal	padahal
pdhal	padahal
pdhl	padahal
pdi	pdip
pdmu	pada
pdt	pendeta
pduli	peduli
peacefully	peace
peb	februari
pebruari	februari
peda	pada
pedes	pedas
pedri	_UNDF
pegi	pergi
pejarakanahok	penjara ahok
pejuang	juang
pejuangsubuh	pejuang subuh
pekaes	pks
pelajari	ajar
pelajrn	pelajaran
pemabok	mabuk
pemaen	pemain
pembeitahuan	beri tahu
pemberitahu	beri tahu
pemberitahuan	beri tahu
pemberitahuan	beri tahu
pemberitahuannya	beri tahu
pemberitahuannya	beri tahu
pemberitauannya	beri tahu
pembertihauan	beri tahu
pemberutahuan	beri tahu
pembnci	benci
pembritahuan	beri tahu
pemerintahanya	pemerintahan
pemimpinberkualitas	pimpin kualitas
pemimpinkafirharam	pimpin kafir haram
pemimpinmuslim	pimpin muslim
pemimpinsejati	pemimpin sejati
pemimpn	pemimpin
pemista	penista
pemmpin	pemimpin
pempin	pimpin
pemprovdki	pemprov dki
pemrintah	pemerintah
pemudaataui	pemuda
pemunjuk	penunjuk
penbenci	benci
pencitraaan	pencitraan
pencitraan	citra
pendungaun	pendunguan
pendzolim	zalim
penegakhukumwajibbersikdildanjujur	tegak hukum wajib adil jujur
penetb	tetap
penfitnah	pemfitnah
pengadila	pengadilan
pengalihanisu	alih isu
pengaturan	atur
penghadangan	hadang
penghianatan	khianat
penghiyanat	pengkhianat
pengikut	ikut
pengin	ingin
pengingat	ingat
penginggat	pengingat
pengkut	pengikut
pengunjunge	pengunjung
peningg	pening
penistaagama	nista agama
penistaagamanangis	nista agama tangis
penistaalquran	nista alquran
penistaan	nista
penistaanagama	nista agama
penistagama	nista agama
penistaquran	nista alquran
penja	penjara
penjagannya	jaga
penjaraahok	penjara ahok
penjarain	penjara
penjarakana	penjara
penjarakanaho	penjara ahok
penjarakanahok	penjara ahok
penjarakanahok	penjara ahok
penjarakanahokh	penjara ahok
penjarakanahokha	penjara ahok
penjarakanahokhar	penjara ahok
penjarakanahokharg	penjara ahok
penjarakanahokhargamat	penjara ahok harga mati
penjarakanahokhargamati	penjara ahok harga mati
penjarakanahokpenistaagama	penjara ahok nista agama
penjarakanbasuki	penjara basuki
penjarakanbtp	penjara btp
penjarakanbuniyani	penjara buniyani
penjarakanpenistaagama	penjara penista agama
penjarakanpenistagama	penjara penista agama
penjarakanpenistagama	penjara penista agama
penjarkan	penjara
penjarkanahok	penjara ahok
penjarq	penjara
penorbanan	korban
penunggangatauaktor	penunggang aktor
penunjuk	tunjuk
penyalahgunaan	salah guna
penyanyin	penyanyi
penyelasain	selesai
peperangan	perang
pepobilang	pepo bilang
peradilankan	peradilan kan
perapihan	rapi
perbaharui	baru
perbaikanny	perbaikannya
perbaikannya	baik
perbaikin	baik
perbanyak	banyak
perbarui	baru
perbnyak	banyak
perbuatanny	buat
percayamah	percaya 
percayslah	percaya
percya	percaya
perempuannn	perempuan
perfec	perfect
perfected	perfect
perhatiin	perhatikan
periksaibas	periksa ibas
perjuanganbelumselesai	perjuangan belum selesai
perjuanganmasihpanjang	juang masih panjang
perkarakanahok	perkara ahok
perkuatukhuwahislamiyah	kuat  islam
perlemen	parlemen
perluu	perlu
permanent	permanen
perna	pernah
pernahh	pernah
pernh	pernah
persatuanumathadapikapitalisme	persatuan umat hadapi kapitalisme
persengkongkolan	sekongkol
persidanganahok	sidang ahok
persiden	presiden
pertanggungjawaban	tanggung jawab
pertanggungjawabannya	tanggung jawab
perubahanpositif	ubah positif
perusakke	rusak
pesen	pesan
pesertademo	peserta demo
pesimist	pesimis
pfft	_EXCL
pfi	_UNDF
pft	_UNDF
pg	_UNDF
pgen	ingin
pghadangan	hadang
pghasiln	hasil
pgluarn	keluar
pgn	_UNDF
ph	_UNDF
phenomenal	fenomenal
phpin	php kan
pi	tapi
pic	picture
pict	picture
pidakan	pidana
pikada	pilkada
pikeun	pikun
pilem	film
pilgubdki	pilgub dki
pilihahok	pilih ahok
pilkadadki	pilkada dki
pilkasa	pilkada
pilm	film
piluh	pilu
pindahin	pindah
pinff	_UNDF
pingin	ingin
pinjem	pinjam
pinter	pintar
pinternya	pintar
pinya	tapi
pjbt	jabat
pjebat	pejabat
pjg	panjang
pk	pak
pkai	pakai
pke	pakai
pkitakutfpi	pki takut fpi
pkl	pukul
pkwt	_UNDF
pl	pula
plajari	pelajari
plaku	pelaku
planggaran	langgar
planning	plan
play	play
playing	play
playstore	play store
plbn	_UNDF
pleasee	please
plecehan	leceh
plg	pulang
plgn	pelanggan
plih	pilih
pling	_UNDF
plintar	plintat
plintir	plintir
plintur	plintir
plis	tolong
plitikus	politik
pljrn	pelajaran
plng	pulang
plototin	lotot
pls	please
pluralrisme	plural
pm	_ETRA
pmbrthuan	beri tahu
pmimpin	pemimpin
pmintatambahankontribusireklamasi	p minta tambahan kontribusi reklamasi
pmuda	pemuda
pn	_UNDF
pnah	punah
pncitraan	citra
pndatang	pendatang
pndemo	demo
pnderitaan	derita
pndh	pindah
pndukung	dukung
pndukungmu	dukung
pngadilan	pengadilan
pngaturan	pengaturan
pngecu	pengecut
pngen	ingin
pngingat	pengingat
pngn	ingin
pngorbananmu	korban
pngusung	usung
pnista	nista
pnistaan	nista
pnjang	panjang
pnjara	penjara
pnjng	panjang
pnjra	penjara
pntang	pantang
pnting	penting
pntng	penting
pnuntun	penuntun
pnutup	penutup
pny	punya
pnya	punya
po	_ETRA
podusen	produsen
pokitik	politik
poko	pokok
pokoe	pokok
pokoke	pokoknya
pokokmen	pokoknya
pokokny	pokok
pokoknya	pokok
pokona	pokok
pokonya	pokoknya
policik	politik
polih	pulih
poling	polling
polisiharusn_ETRAl	polisi harus n_ETRAl
polisimilikrakyat	polisi milik rakyat
polisitakut	polisi takut
polisitakutfpi	polisi takut fpi
politi	politik
politic	politik
political	politic
politician	politik
politicians	politician
politics	politik
politikbebasaktif	politik bebas aktif
politikbuaya	politik buaya
politikny	politik
politisibusuk	politik busuk
politk	politik
politukus	politik
poll	polling
polling	poll
pollingnya	poll
polriharusn_ETRAl	polri harus n_ETRAl
polrin_ETRAl	polri n_ETRAl
poltik	politik
popmie	pop mie
posting	post
postingan	post
potrait	potret
ppl	people
ppolaritasnya	populer
pradilan	adil
praktek	praktik
praperadilanpengadilan	praperadilan adil
prapreadilan	praperadilan
prasaan	perasaan
praud	proud
prayer	pray
prayers	pray
prayforahok	pray for ahok
prayforindonesia	pray for indonesia
praying	pray
prbandingan	banding
prbarui	perbarui
prcaya	percaya
prcy	percaya
predecessors	predecessor
prema	preman
presentsi	presentasi
presidenn_ETRAl	presiden n_ETRAl
president	presiden
presidenya	presiden
prestan	protestan
prgi	pergi
pribumimemimpin	pribumi pimpin
priem	_UNDF
prihatinalasby	prihatin ala sby
prikemanusian	perikemanuasiaan
prilaku	perilaku
priode	periode
priorities	priority
pristiwa	peristiwa
privileges	privilege
prmhn	perumahan
prmptn	perempatan
prnah	pernah
prnh	pernah
prnyataanmu	nyata
prnyatn	nyata
prob	pro
processes	process
produck	product
professionalism	profesional
programataujanji	program janji
promony	promo
promonya	promo
promos	promo
promosiin	promosi
proove	prove
prosenya	proses
proseshukum	proses hukum
prrsen	persen
prses	proses
prtai	partai
prthnkn	pertahankan
prubahan	ubah
prustasi	frustasi
psg	pasang
psidangan	sidang
psikososial	psiko sosial
psl	pasal
psng	pasang
psr	pasar
pst	pasti
psti	pasti
ptg	penting
ptrn	putaran
puanas	panas
puasssss	puas
pubilk	publik
public	publik
publikaikan	publik
pulak	pula
pulitik	politik
pulkada	pilkada
pulo	pula
puna	punah
pungliataukorupsiataulelet	pungli korupsi lelet
pungsipemerintah	fungsi pemerintah
punished	punish
punye	punya
purak	pura
pusiang	pusing
putara	putar
putaran	putar
putaranahokdjarot	purat ahok djarot
putaranforahok	putar for ahok
putarang	putar
putaranpilkada	putaran pilkada
putaranpilkadadki	putar pilkada dki
putaransaja	putaran saja
putarn	putar
puter	putar
putera	putra
puterin	putar
putting	put
putuskn	putus
py	_UNDF
qabul	kabul
qiqiqi	_LOL
qolbu	kalbu
qs	_ETRA
qt	kita
qta	kita
qur	alquran
qur an	alquran
quran	alquran
quran	alquran
quran	alquran
quranx	alquran nya
rabb	rabbi
rabbal	rabbi
rabbi	allah
rabbika	rabbi
rabo	rabu
rachmatan	rahmat
racism	race
racist	race
racists	race
rada	agak
radical	radikal
radicals	radical
rahmatmaliki	rahmat malik
raising	rise
rajakoruptor	raja koruptor
rakyatcerdas	rakyat cerdas
rakyt	rakyat
ramasan	rampasan
rame	ramai
rame2	ramai-ramai
rameken	ramai
ramekeun	ramai
rampasaan	rampasan
rangorang	orang
ranking	rank
rasain	rasakan
rasane	rasanya
rascals	rascal
rasionalitas	rasional
rasts	_UNDF
rates	rate
ratingnya	rate
rayain	raya
rb	ribu
rbuan	ribu
reached	reach
reader	read
reak	teriak
realitanya	realita
realy	really
reborn	born
reclamation	reklamasi
recomended	recommended
refrensi	referensi
refreshed	refresh
regardless	regard
rejected	reject
rekayasana	rekayasa
reklamator	reklamasi
reklmasi	reklamasi
relations	relation
relawan	rela
religious	religion
removed	remove
remukkin	remuk
ren	_UNDF
renew	new
renfah	rendah
repost	post
res	_UNDF
rese	usil
resiko	risiko
respech	respect
respects	respect
responnya	respon
retweets	tweet
retwet	tweet
revealed	reveal
revolution	revolusi
rewardnya	reward
rg	ragu
rh	_UNDF
rhs	rahasia
ribet	ruwet
ribuaan	ribu
rights	right
rinduyang	rindu yang
ripd	dari pada
ripdki	rip dki
ripintan	rip intan
rippancasila	rip pancasila
rising	rise
ritetapdamai	tetap damai
ritetaplahdamai	tetap damai
riziek	rizieq
riziq	rizieq
rizkimu	rezekimu
rkyt	rakyat
rmbt	rambut
rmh	rumah
rmhq	rumahku
rncana	rencana
rngkaian	rangkai
robb	allah
roll	roll
rompiorenkenahok	rompi kena ahok
rooting	root
rosulullah	rasulullah
rot	jarot
rsk	rusak
rspect	respect
ruar	luar
rubah	ubah
ruf	_UNDF
runs	run
rupo	rupa
rushmoney	rush money
saalam	salam
saatnanti	saat nanti
sabangmerauke	sabang merauke
sabarr	sabar
sadarlahahokers	sadar ahoker
sae	_UNDF
sagat	sangat
sahabatahok	sahabat ahok
saje	saja
salaam	salam
salaamnya	salam
salahatautidaknya	salah tidak
salahin	salah
salahny	salah nya
salahsatunya	salah satu
salambudaya	salam budaya
salamcemangat	salam semangat
salamdamai	salam damai
salamjari	salamduajari
salamjarisolo	salamduajari solo
salamsalamjarisolo	salam dari solo
salamsatuputaran	salam satu putaran
salh	salah
sallam	salam
salm	salam
saloom	salam
salute	salut
salutt	salut
saluut	salut
sam	sama
samain	samakan
samakan	sama
samapi	sampai
samatetap	sama tetap
samaung	samsung
sambel	sambal
same	sama
samg	sama
samgalgift	_UNDF
sami	sampai
samo	sama
sampaiin	sampai
sampay	sampai
sampe	sampai
sampein	sampai
samsunggg	samsung
samsungggg	samsung
samsungjprime	samsung j prime
samsungnya	samsung nya
sanagat	sangat
sanagt	sangat
sanah	sana
sandiawaraahok	sandiwara ahok
sandiwaraahok	sandiwara ahok
sangaaaaaaattttt	sangat
sangaat	sangat
sangant	sangat
sangatt	sangat
sangay	sangat
sangkat	singkat
sangsangat	sangat
sangt	sangat
sansos	bansos
sante	santai
sape	si
sare	tidur
satukali	satu kali
satunya	satu
satuputaran	satu putaran
satus	ratus
satusuarabelaquran	satu suara bela alquran
satux	satunya
saveahok	save ahok
saveahok	save ahok
savebuniyani	save buniyani
savefpideleteahok	save fpi delete ahok
savehumanity	save humanity
saveindonesi	save indonesia
saveindonesia	save indonesia
saveislam	save islam
saveislamsavenkri	save islam save nkri
savejakarta	save jakarta
savemui	save mui
savenkri	save nkri
saveorangbaik	save orang baik
savepakahok	save pak ahok
savepalestine	save palestina
saves	save
savetolerance	save tolerance
sayaa	saya
sayaahok	saya ahok
sayabelafpi	saya bela fpi
sayabersamaahok	saya sama ahok
sayah	saya
sayaharap	saya harap
sayaindonesia	saya indonesia
sayaingin	saya ingin
sayamerasakan	saya rasa
sayapercayabk	saya percaya bk
sayapilihahok	saya pilih ahok
sayatethok	saya tetap ahok
saynotobigot	say no to bigot
saynotopki	say no to pki
says	say
sbab	sebab
sbagai	bagai
sbaliknya	balik
sbar	sabar
sbb	sebab
sbelum	belum
sber	_UNDF
sbg	sebagai
sbg	sebagai
sbgai	bagai
sbgai	bagai
sbgaimana	bagai
sbgi	bagai
sbh	subuh
sbisa	bisa
sbl	sebelah
sblh	sebelah
sblhny	sebelahnya
sblikny	balik
sblm	sebelum
sblmny	sebelumnya
sblmnya	sebelumnya
sblum	belum
sblumnya	sebelum
sbnarnya	benar
sbner	sebenar
sbnr	sebenarnya
sbnrny	sebenarnya
sbnrnya	sebenarnya
sbnt	sebentar
sbntar	bentar
sbntr	sebentar
sbr	sabar
sbtr	sebentar
sbtulnya	sebetulnya
sbuah	buah
sbuk	sibuk
sbun	sabun
sbyahy	sby
sbydkk	sby
sbysudahlah	sby sudah
sbyudhoyono	sby
scandal	skandal
scepatnya	cepat
scpatnya	cepat
scr	secara
sd	sedang
sdah	sudah
sdang	sedang
sdangkan	sedangkan
sdg	sedang
sdgkan	sedang
sdgkn	sedangkan
sdh	sudah
sdh	sudah
sdkt	sedikit
sdktpun	sedikit
sdng	sedang
sdngkn	sedangkan
sdrlah	sadar
seadila	adil
seadilseadilnya	adil
seadilseadilnya	adil
seaqidah	aqidah
sebag	bagian
sebaga	bagai
sebeeelllll	sebel
sebel	kesal
sebelumnya	sebelum
sebenar	benar
sebenarny	benar
sebenarnya	benar
sebenernya	sebenarnya
seber	_UNDF
seberatseberatnya	berat
sebetulnya	betul
sebutin	sebut
secepat	cepat
secepet	secepat
securely	secure
sedangkan	sedang
sedehana	sederhana
sediih	sedih
sedikiy	sedikit
seen	see
seengak	tidak
seeprti	seperti
segal	segala
segala	gala
segalacara	segala cara
segerapenjarakanahok	segera penjara ahok
segeratahanahok	segera tahan ahok
segimana	segi mana
segitu	gitu
segitunya	gitu
segitunyeh	gitu
segra	segera
seharusx	harus
sei	_UNDF
sejujur	jujur
sekale	kali
sekalee	sekali
sekaliahoktethok	kali ahok tetap ahok
sekalteng	se kalteng
sekarianisme	sektarianisme
sekarng	sekarang
sekitary	sekitar
sekli	sekali
sekola	sekolah
sekolompok	kelompok
selaen	selain
selajutnya	selanjut
selamatkanindonesia	selamat indonesia
selamatkanjakarta	selamat jakarta
selamatkn	selamat
selasasabtu	selasa sabtu
selau	selalu
selebay	lebay
selegowo	legowo
self	self
selfinya	self
sellu	selalu
selow	sebentar
selsai	selesai
semakinahok	makin ahok
semalem	semalam
semanga	semangat
semangaat	semangat
semangatpak	semangat pak
semangatpakahok	semangat pak ahok
semangatt	semangat
semanggat	semangat
sembaranagan	sembarang
sembilannaga	sembilan naga
sembuhin	sembuhkan
semngat	semangat
semngt	semangat
semntara	sementara
semoga	semoga
semogaa	semoga
sempet	sempat
semuany	semua
senangnya	senang
sendri	diri
senen	senin
seneng	senang
sensi	sensitif
sensitifitas	sensitif
sentara	sementara
sentilin	sentil
senyam	senyum
senyumaja	senyum saja
seoalah	olah
seoalh	olah
seola	olah
seorang	orang
seorg	seorang
seorng	orang
sepelti	seperti
sepertibuniyani	seperti buniyani
sepertinyadialeleah	sepertinya dia lelah
seprti	seperti
seranganjantung	serangan jantung
serem	seram
seribuk	seribu
seringgila	srigala
seringkali	sering
servernya	server
sese	_UNDF
sesek	sesak
seseorg	orang
sesugguhnya	sungguh
setabil	stabil
setdknya	tidak
setengah	tengah
setoojoo	setuju
setrong	strong
setting	set
seya	saya
sfs	_UNDF
sgala	segala
sgelintir	segelintir
sgi	_UNDF
sgl	segala
sgra	segera
sgt	sangat
shalat	shalat
shalat	sholat
shalatm	shalatmu
shalatmu	shalat
shalatmu	sholat
shalatnya	shalat nya
shalatsubuhbejamaah	shalat subuh jamaah
shameful	shame
shameonyousby	shame sby
shbt	sahabat
shg	hingga
shingga	hingga
shining	shine
shipping	ship
shirtnya	shirt
shlat	shalat
shoheh	sholeh
shola	sholat
sholaat	sholat
sholat	shalat
sholatberjamaah	shalat jamaah
sholatin	sholat
sholatnya	sholat
sholatnya	sholat
sholatnya	sholat
sholatx	sholat
sholt	sholat
shopback	shop back
showed	show
shrsx	harus
shrusnya	harus
shubuh	subuh
shubuhberjamaah	subuh jamaah
siaaa	si
siahok	si ahok
siain	sia
siapin	siap
siapkn	siap
siarin	siar
sibabi	si babi
sibangsat	si bangsat
sibuniyani	si buniyani
sich 	_PRTL
sidah	sudah
sidangahok	sidang ahok
sidangahoklive	sidang ahok live
sidangdagelan	sidang dagelan
sidangkasusahok	sidang kasus ahok
sidangkedua	sidang dua
sidangliveny	sidang live
sidangperdana	sidang perdana
sidangperdanaahok	sidang perdana ahok
sides	side
sidi	sidik
sie	_PRTL
sih	_PRTL
sihat	sehat
siiaapp	siap
siiiiip	sip
siiiip	sip
siik	_EXCL
siip	sip
sikaat	sikat
sikafir	kafir
sikaya	kaya
sikonnya	situasi kondisi
silagi	lagi
sile	sila
silence	silent
silhkn	silahkan
silvyy	silvy
similirities	similar
simpat	sempat
simpen	simpan
singkron	sinkron
sionta	onta
sipembohong	bohong
sipengobral	obral
sipenista	si penista
sirit	_UNDF
sist	_PRON
sitersangka	sangka
sitting	sit
situation	situasi
situations	situation
situkang	tukang
siy	_PRTL
sj	saja
sja	saja
sjak	sejak
sjk	sejak
sjujurnya	jujur
sk	suka
ska	suka
skali	sekali
skalian	sekalian
skalipun	sekali
skarang	sekarang
skg	sekarang
skit	sakit
sklh	sekolah
skli	sekali
sklil	sekali
sklompok	kelompok
skola	sekolah
skolah	sekolah
skr	sekarang
skrang	sekarang
skrg	sekarang
skrng	sekarang
skrny	kira
skt	sakit
slah	salah
slalu	selalu
slama	selama
slamanya	selama
slamat	selamat
slamet	selamat
slanjutnya	selanjut
slesai	selesai
slese	selesai
slg	saling
slh	salah
slhkn	salahkan
sll	selalu
sllu	selalu
slm	salam
slma	selama
slmat	selamat
slmt	selamat
slng	saling
slrh	seluruh
slruh	seluruh
sls	selesai
slsaikan	selesai
sluruh	seluruh
sm	sama
sma	sama
smagt	semangat
smakin	semakin
smangat	semangat
smarinda	samarinda
smartphon	smart phone
smber	sumber
smbg	sambung
smbh	sembuh
smbhyg	sembahyang
smbil	sambil
smbl	sambil
smbng	sambung
smbr	sumber
smbrg	sembarang
smbuh	sembuh
smcm	semacam
smengat	semangat
smg	semoga
smga	semoga
smgat	semangat
smgt	semangat
smgtt	semangat
smiling	smile
smjak	semenjak
smkin	semakin
smkn	makin
smknn	makin
smlm	semalam
smlmn	semalaman
smngat	semangat
smngt	semangat
smntr	sementara
smoga	semoga
smogaa	semoga
smp	sampai
smpai	sampai
smpat	sempat
smpe	sampai
smpt	sempat
smpurna	sempurna
smswa	sms wa
smtara	sementara
smua	semua
smua	semua
smuanya	semuanya
smw	semua
snang	senang
sndiri	sendiri
sndirinya	sendiri
sndri	sendiri
sngaja	sengaja
sngat	sangat
sngn	senangnya
sngt	sangat
sni	sini
snilai	nilai
soale	soalnya
soalna	soal
soan	soal
sob	_PRON
socmed	sosmed
sodara	saudara
sodaraku	saudara
soedirman	sudirman
soekarno	sukarno
sohib	sahabat
soholat	sholat
sokap	bokap
soksokan	sombong
solat	sholat
solodaritas	solidaritas
solving	solve
sometimes	sometime
songang	sombong
sono	sana
soo	so
sopo	si
sorakin	sorak
sorang	seorang
sory	maaf
sosmed	medsos
sosmednya	sosmed
speachless	speechless
spenuh	penuh
sperti	seperti
spertii	seperti
spertinya	seperti
spiritberj	spirit jamaah
spiritberjamaa	spirit jamaah
spiritberjamaah	spirit jamaah
spiritgn	spirit
spirituality	spiritual
spnjng	sepanjang
sprt	seperti
sprter	_UNDF
sprti	seperti
sprtny	sepertinya
sprtnya	seperti
spt	seperti
spt	seperti
spti	seperti
sptny	sepertinya
sptnya	sepertinya
spy	supaya
sr	_UNDF
srg	sering
srigala	serigala
srkali	sekali
srt	surat
srta	serta
sruput	minum
ssalam	salam
ssuatu	suatu
staless	_UNDF
stanby	stand by
standart	standard
standby	stand by
standforahok	stand for ahok
standing	stand
standontherightside	stand right side
stasion	stasiun
statua	status
staycoll	stay cool
staystrong	stay strong
stelah	setelah
stengah	setengah
stepback	step back
stgh	setengah
stiap	setiap
stipulated	stipulate
stlah	setelah
stlh	setelah
stngh	setengah
stopairmatabuaya	stop air mata buaya
stopkriminalisasiulama	stop kriminalisasi agama
stoppengalihanisu	stop alih isu
stor	store
streaming	stream
strength	strong
stress	stres
stressjagoannya	stress jagoan
stronger	strong
sttus	status
suaranyah	suara
subhan	subhana
subhnnlh	subhanallah
subj	subjek
subuhakbar	subuh akbar
subuhberjamaah	subuh jamaah
subuhberjamaan	subuh jamaah
subuhberjemaah	subuh jamaah
suciatielok	elok
sudh	sudah
suee	_UNDF
sukaa	suka
sukaaaa	suka
sukano	sukarno
sukro	sukur
sumpahin	sumpah
sunggal	tunggal
superb	superb
superdamai	super damai
supo	super
suport	support
suppeeerrr	super
suppo	support
supportahok	support ahok
supporting	support
supportnya	support
suprihatin	prihatin
surabayanya	surabaya
surban	sorban
surpey	survey
surprised	surprise
suru	suruh
surveynya	survey
suspec	suspect
suspected	suspect
sweeping	sweep
swepping	sweep
swimming	swim
swingvoter	swing voter
swingvoters	swing voter
sy	saya
sy	saya
sy	si
sya	saya
sya	_UNDF
syaa	_UNDF
syafi	syafii
syahidjihadil	syahid jihad
syaloom	salam
syamsudin	syamsuddin
syang	sayang
syareat	syariat
syaykhunaa	_UNDF
syedih	sedih
syekaleee	sekali
syetan	setan
syg	sayang
sygny	sayangnya
syihab	shihab
syilvie	sylvi
sykurlah	syukur
sylviterus	sylvi terus
symbol	simbol
symuslim	saya muslim
syng	sayang
syngnya	sayang
system	sistem
syukurin	syukur
syuriyah	suriah
t rbaik	baik
t rbaik	baik
t rbaik	terbaik
ta	kan
taatulama	taat ulama
tabayyunkan	tabayyun
tablighakbar	tabligh akbar
tabokin	serang
tadu	_UNDF
tadz	ustadz
taggar	tagar
tahanahak	tahan ahok
tahanahok	tahan ahok
tahanahox	tahan ahoak
tahankoruptor	tahan koruptor
tahanpenista	tahan nista
tahanpenistaagama	tahan nista agama
tahanterdakwa	tahan dakwa
tahunpsimembelakeragaman	tahun bela ragam
tai	tahi
taii	tahi
taik	tahi
taik	tahi
taiker	tahi
taikers	tahi
tajem	tajam
tak	tidak
tak	tidak
tak	tidak
takbela	akan bela
takes	take
talangin	talang
talking	talk
taller	tall
tambaah	tambah
tambahan	tambah
tambahin	tambah
tambahjn	tambah
tampa	tanpa
tandinga	tanding
tang	_UNDF
tangal	tanggal
tangisanbuaya	tangis buaya
tangisandusta	tangis dusta
tangispo	tangis
tangispolitik	tangis politik
tangkapkoruptor	tangkap koruptor
tangkappenista	tangkap nista
tangkappenistaagama	tangkap penista agama
tangkappenistaalquran	tangkap nista alquran
tangkappenistaquran	tangkap nista alquran
tangkappenjarakan	tangkap penjara
tangkappenjarakanahok	tangkap penjara ahok
tangkep	tangkap
tangkep	tangkap
tangkhok	tangkap ahok
tangkhokpenistaagama	tangkap ahok nista agama
tangkhon	tangkap ahok
tangkhox	tangkap ahoak
tankks	thank
tanksu	thank
tano	tanoe
tanpamelawan	tanpa lawan
tanpkai	tanpa pakai
tanyanganmu	tayang
taon	tahun
tapu	tapi
tar	nanti
tat	_UNDF
tau	tahu
tau	tahu
taun	tahun
taunya	tahunya
tawakalna	tawakal
tb	_UNDF
tbaik	baik
tbts	batas
td	tadu
tdak	tidak
tdi	tadi
tdk	tidak
tdk	tidak
tdknya	tidak
tdny	tadinya
tdr	tidur
tdur	tidur
teamahokdjarot	tim ahok djarot
teamcengeng	team cengeng
tears	tear
tebel	tebal
tebukti	bukti
teelalu	terlalu
teerus	terus
teesangka	sangka
teeyus	terus
tegakang	tegak
tegakin	tegak
tegakkanhukum	tegak hukum
tegakkankeadilan	tegak adil
tegakkansupremasihukum	tegak supremasi hukum
tegakkansyariah	tegak syariah
tekibul	kabul
telanjangin	telanjang
telenovella	telenovela
telfon	telepon
telkenal	kenal
telor	telur
telp	telepon
telpedaya	daya
telpon	telepon
temanahok	teman ahok
temanahokmlg	teman ahok malang
temans	teman
temanx	teman
temen	teman
temen2	teman-teman
temenan	teman
temenin	temani
temennya	teman
temlen	timeline
temui	temu
tenaang	tenang
tenag	tenang
tenatng	tenang
tengkiyu	thank
tentramnya	tentram
tepatin	tepati
tepokjidat	tepok jidat
terahir	terakhir
terahok	ahok
terakhir	akhir
teraniya	aniaya
teraniyaya	aniaya
terasangka	sangka
terbuay	buai
terdakwaahok	dakwa ahok
terdakwaatauterpidana	dakwa pidana
terdakwatapitidakditahan	dakwa tapi tidak tahan
terdawa	dakwa
terdektesi	terdeteksi
terdengar	dengar
terdeteksi	deteksi
terdholimi	zalim
terdt	data
terdzalimi	zalim
terdzolimi	zalim
terfavorit	favorit
tergurus	tergerus
terhitzzz	hit
terijabah	ijabah
terimakas	terima kasih
terimakasi	terima kasih
terimakasih	terima kasih
terimaksh	terima kasih
terimaksih	terima kasih
terjalimi	zalim
terjd	jadi
terjerembab	jerembab
terlbh	lebih
termasuk	masuk
termehek	mehek
termsk	termasuk
terngahokngahok	ahoak
terngakak	ngakak
ternyata	nyata
teroos	terus
terorganisiir	organisir
teros	terus
terpavorit	terfavorit
terpidanapenistaagama	pidana nista agama
terrorist	teroris
tersangak	sangka
tersangaka	sangka
tersangk	sangka
tersangkaatauter	sangka 
tersangkakanahok	sangka ahok
tersangkapenistaanagama	sangka nista agama
tersanka	sangka
tersbt	tersebut
tersebut	sebut
tersengka	sangka
tertawa	tawa
tertentu	tentu
tertentunyang	tertentu
tertwa	tertawa
terurama	terutama
teruss	terus
terutk	untuk
terwujut	wujud
terzholimi	zalim
terzolim	zalim
terzolimi	zalim
tesangka	sangka
testonthewater	test water
tet	tetap
tetapdukungahok	tetap dukung ahok
tetapfokus	tetap fokus
tetaphukumahok	tetap hukum ahok
tetapkawal	tetap kawal
tetapmengasihi	tetap kasih
tetapnkri	tetap nkri
tetapsalam	tetap salam
tetapsemangatahok	tetap semangat ahok
tetapwaspada	tetap waspada
tetat	tetap
tetatplah	tetap
tetbg	_UNDF
teteap	tetap
tetep	tetap
tetepahok	tetap ahok
tetepdukungahokmaju	tetap dukung ahok maju
tetepkritis	tetap kritis
tetet	tetap
teteup	tetap
tethok	tetap ahok
tethokdjarot	tetap ahok djarot
tethokdjarotdki	tetap ahok djarot dki
tethokjarot	tetap ahok djarot
tetpa	tetap
teuteup	tetap
tg	_UNDF
tggu	tunggu
tgh	tengah
tgl	tanggal
tgn	tangan
tgs	tugas
th	_UNDF
thailandnya	thailand nya
thaja	tjahaja
thaks	thank
thanks	thank
thats	that
thd	terhadap
thdp	terhadap
theirs	their
themselves	they
thetrue	the true
thia	this
things	thing
things	thing
thinking	think
thinks	think
thn	tahun
thnks	thank
thnx	terima kasih
tho	_EXCL
tholo	_UNDF
thought	think
thoughts	think
thousands	thousand
thrust	trust
ths	_UNDF
thugs	thug
thx	terima kasih
ti	_UNDF
tiak	tidak
tiati	hati hati
tida	tidak
tidaka	tidak
tidakadil	tidak adil
tidakny	tidak
tidk	tidak
tidka	tidak
tihan	tuhan
tilep	tilap
times	time
timlen	timeline
timr	tim
tinggalin	tinggal
tingggi	tinggi
tingkatin	tingkatkan
tingkatkan	tingkat
tingkatkannnnn	tingkatkan
tionghowa	tionghoa
tipi	tv
titled	title
titokarna	tito karnavian
titotitotitoot	tito
tivu	tipu
tizen	netizen
tj	_UNDF
tjahaj	tjahaja
tjahaya	tjahaja
tjahja	tjahaja
tjahya	tjahaja
tjanggih	canggih
tjd	jadi
tk	tidak
tka	_UNDF
tks	thank
tkt	takut
tkut	takut
tl	timeline
tlah	telah
tlalu	lalu
tlg	tolong
tlh	telah
tlh	telah
tlng	tolong
tlong	tolong
tlp	telepon
tlpn	telepon
tlt	telat
tmbah	tambah
tmbh	tambah
tmen	teman
tmn	teman
tmnnya	teman
tmpat	tempat
tmpt	tempat
tmsk	termasuk
tmsuk	masuk
tnang	tenang
tngah	tengah
tnggal	tinggal
tnggl	tinggal
tnh	tanah
tnjakan	tanjakan
tnpa	tanpa
tntg	tentang
tny	ternyata
tnya	tanya
tnyata	nyata
tnyt	ternyata
tobatt	tobat
tofic	topic
tokohataupejabat	tokoh pejabat
toktoktok	_ETRA
tolakahok	tolak ahok
tolakanarkis	tolak anarkis
tolakdemokrasi	tolak demokrasi
tolakeksepsiahok	tolak eksepsi ahok
tolakkoruptor	tolak koruptor
tolakpemimpinkafir	tolak pimpin kafir
tolakreklamasi	tolak reklamasi
tolaksistemkufur	tolak sistem kafir
tolakteroris	tolak teroris
tolang	tolong
toleransidamai	toleransi damai
tolng	tolong
to_LOLhaha	to_LOL 
took	take
tooooop	top
topics	topic
topmarkotop	top
totaly	total
tourism	tourist
tp	tapi
tpat	tepat
tpi	tapi
tpt	tepat
tq	terima kasih
trading	trade
trahir	terakhir
trakhir	terakhir
tranding	trend
trandingtopik	trend topic
tranfer	transfer
traniaya	aniaya
tranparansi	transparansi
transferanya	tranfer
transkip	transkrip
trbayang	bayang
trbk	buka
trcnta	cinta
trdakwa	dakwa
trdpt	terdapat
treak	teriak
treated	treat
treding	trade
tren	trend
trending	trend
trendingsalam	trend salam
trendrs	trend
trends	trend
trendsetter	trend setter
trendtop	trend top
trgantung	gantung
trgntng	tergantung
trhdap	hadap
triak	teriak
trial	trial
trials	trial
tricky	trick
tried	try
trik	trik
trikataucheat	trik cheat
triliyun	trilyun
trilyun	triliun
trilyun	triliun
trima	terima
trimah	terima
trimakasi	terima kasih
trimakasih	terima kasih
trimaksih	terima kasih
trimkasih	terima kasih
trims	terima kasih
trjadi	jadi
trjatuh	jatuh
trjd	jadi
trjdi	jadi
trjpit	jepit
trkdng	terkadang
trkenal	kenal
trkhr	terakhir
trlalu	terlalu
trlantar	lantar
trlihat	lihat
trm	terima
trma	terima
trmakan	makan
trmasuk	masuk
trmksh	terima kasih
trmsk	termasuk
trnsfr	transfer
trnyata	ternyata
trnyt	ternyata
trnyta	nyata
trpeleset	peleset
trpengaruh	pengaruh
trpksa	paksa
trpukul	pukul
trpuruk	terpuruk
trr	_UNDF
trs	terus
trs	terus
trsangka	sangka
trsenyum	senyum
trsesat	tersesat
trsgka	sangka
trsngk	sangka
trsngka	sangka
trsngkat	angkat
trsrh	terserah
trtawa	tawa
trtawakan	tawa
trtinggi	tinggi
trtma	utama
trtnds	tanda
trtwa	tawa
truemartyr	true martyr
trumps	trump
trungkap	ungkap
trus	terus
truss	terus
trustingod	trust god
truz	terus
tryata	nyata
trying	try
tryta	nyata
trz	terus
tsangka	sangka
tsb	tersebut
tsbt	tersebut
tsgka	sangka
tskan	_UNDF
tst	tahu sama tahu
tt	trend topic
ttangga	tetangga
ttap	tetap
ttapi	tapi
ttd	tanda tangan
ttep	tetap
ttg	tentang
ttg	tentang
ttng	tentang
ttp	tetap
ttp	tetap
ttpi	tapi
ttpkan	tetap
ttplah	tetap
ttup	tutup
ttwi	_UNDF
ttww	trend topic worldwide
tu	itu
tuch	_EXCL
tuh	itu
tuhantidaktidur	tuhan tidak tidur
tuhh	_EXCL
tuhkan	_EXCL
tujjar	_UNDF
tuker	tukar
tukeran	tukar
tulahnye	tulah nya
tulisannya	tulisan
tulisanya	tulisannya
tumben	tidak biasa
tumpeh	tumpah
tungguin	tunggu
tungu	tunggu
tunjukin	tunjuk
tunjukkin	tunjuk
tunjukkn	tunjuk
tuntaskankasusbasuki	tuntas kasus basuki
tuntuk	untuk
tuntuna	tuntunan
turning	turn
turunin	turun
tvnya	tv
tw	tahu
tweeter	twitter
twet	tweet
twetter	twitter
twins	twin
twit	tweet
twitbot	tweet bot
twitt	tweet
twittertrend	twitter trend
twitw	tweet
twitwar	tweet war
twrbaik	baik
twrima	terima
twrsangka	sangka
tx	thank
tyranny	tirani
tyuz	terus
uangatau	uang
ubat	obat
ubunnya	ubun
ucapqn	ucn
ud	sudah
uda	sudah
udah	sudah
udahlah	sudah
udahlahh	sudah
udd	_UNDF
ude	sudah
udeh	sudah
udh	sudah
udhga	sudah tidak
udzubillah	nauzubillah
ug	_UNDF
ugalan	ugal
ugalugalan	ugal
ugama	agama
ujan	hujan
ujan2an	hujan-hujanan
ujunge	ujungnya
ujungnya	ujung
ujungujungnya	ujung
umatislambersatulah	umat islam satu
umatny	umat
umatsesama	umat sama
ummat	umat
ummatihi	umat
umn	_UNDF
umoh	umroh
umrohkan	umroh
umumin	umum
un	_UNDF
unfoll	foloow
ungkapkn	ungkap
ungkpan	ungkap
univetsal	universal
unk	_UNDF
unktdkmemusuhi	untuk tidak musuh
unt	untuk
untk	untuk
untkmu	untuk
unttuk	untuk
untu	untuk
untukmngingatkan	untuk mengingatkan
untukv	untuk
upa	lupa
updaters	update
updating	update
upgrede	upgrade
uplikasi	aplikasi
ups	_EXCL
ur	_UNDF
urusin	urus
usahaatasimandanamalsholeh	usaha atas iman dan amal sholeh
usahax	usaha
usak	rusak
usefull	useful
ush	_UNDF
usilin	usil
usirahok	usir ahok
usirchina	usir cina
usircina	usir cina
usirhabibkresek	usir habib kresek
ust	ustadz
usutpendanademo	usut dana demo
ut	_UNDF
uta	_UNDF
utk	untuk
utk	untuk
utuk	untuk
uuduud	uud
uun	_UNDF
uuu	_UNDF
uuuwwwaaauuuu	_EXCL
uwong	uang
valuable	value
vbagusss	bagus
verry	very
victordjarotdki	victory djarot dki
vid	video
vidio	video
views	view
vocer	voucher
vocher	voucher
voor	for
voteahok	vote ahok
voucer	voucher
voucherny	voucher  nya
vouchernya	voucher
vscocam	_UNDF
vu	_UNDF
waaaw	_EXCL
waay	_EXCL
wabarikatu	salam
wadjdi	_UNDF
waduh	_EXCL
wakakak	_LOL
wakakakakak	_LOL
wakakakakaka	_LOL
wakqkqkq	_LOL
waktua	waktu
waktuakan	waktu akan
waktuberjamaah	waktu jamaah
waktudan	waktu dan
waktuny	waktu
waktunya	waktu
waktuu	waktu
waktuy	waktunya
wakwaw	_LOL
wal	_UNDF
walaikum	salam
walo	walau
walopun	walau
walupun	walau
wanna	want
warbyazah	luar biasa
wargacerdas	warga cerdas
warnax	warna
wassalamukum	wassalam
watau	atau
watga	warga
waw	_EXCL
weareahok	we ahok
wedeh	_EXCL
wefight	we fight
wehh	_EXCL
wei	_EXCL
wek	_EXCL
wella	_EXCL
wes	_EXCL
westandforahok	west and for ahok
wew	_EXCL
wh	_EXCL
whats	what
wi	_EXCL
wings	wing
winning	win
wins	win
wirausahawan	wirausaha
wis	sudah
wjar	wajar
wjkwkwjjkw	_LOL
wk	_LOL
wkakwk	_LOL
wkkwkwkwk	_LOL
wkt	waktu
wktnya	waktu
wktu	waktu
wkwk	_LOL
wkwkkwkk	_LOL
wkwkkwkwk	_LOL
wkwkwk	_LOL
wkwkwkkw	_LOL
wkwkwkwk	_LOL
wkwkwkwkw	_LOL
wkwkwkwkwk	_LOL
wkwkwkwkwkk	_LOL
wkwkwkwkwkw	_LOL
wkwkwkwwk	_LOL
wl	walau
wlopun	walau
wlpn	walau
wlupun	walau
wlw	walau
wlwpun	walaupun
wn	_UNDF
wo	_UNDF
woah	_EXCL
woles	santai
wont	will not
woooow	_EXCL
wow	_EXCL
woy	_EXCL
wr	salam
wrg	warga
wrga	warga
ws	_UNDF
wufht	_EXCL
wuih	_EXCL
ww	_LOL
wwtt	_LOL
xa	_UNDF
xixixi	_LOL
xo	_UNDF
xtp	_UNDF
yaa	ya
yaaa	ya
yaah	ya
yaallah	ya allah
yach	ya
yaelah	ya
yah	ya
yahh	ya
yaiyalah	ya
yak	ya
yakan	ya kan
yakk	ya
yanf	yang
yangg	yang
yanh	yang
yaopo	ya apa
yatakan	nyata
yaudah	ya sudah
yaudh	ya sudah
ydh	ya sudah
ye	ya
yeaayy	_EXCL
yeayyy	_EXCL
yee	ya
yeh	ya
yeumil	yaumil
yey	ya
yg	yang
yg	yang
ygngejolimin	yang zalim
ygvtidak	yang tidak
yh	ya
yi	ya
yiao	_EXCL
yiou	_EXCL
yk	ya
ykin	yakin
ykn	yakin
yng	yang
yo	ya
yoman	yaman
yoo	ya
youllneverwalkalone	ynwa
youneverwalkalone	ynwa
yoy	ya
ysalaharah	salah arah
yuhuuu	_EXCL
yup	ya
yupss	ya
yuukk	yuk
ywdh	ya sudah
ywdlah	ya sudahlah
zamannya	zaman
zamanx	zaman
zhalim	zalim
zhalimi	zalim
zholim	zalim
zholim	zalim
zholimi	zalim
zolim	zalim
zolimi	zalim
zupeer	super
